,matchId,fouls,total fouls,fouls in second half,fouls in first half,first half foul density,second half foul density
0,2500686,"[1.0, 3.0, 13.0, 20.0, 21.0, 23.0, 31.0, 31.0, 37.0, 40.0, 41.0, 44.0, 44.0, 48.0, 50.0, 51.0, 54.0, 57.0, 59.0, 61.0, 64.0, 67.0, 68.0, 72.0, 74.0, 79.0, 80.0, 81.0, 82.0, 84.0, 85.0, 87.0]",32,19,13,0.40625,0.59375
1,2500687,"[9.0, 13.0, 17.0, 23.0, 25.0, 27.0, 32.0, 35.0, 37.0, 39.0, 45.0, 46.0, 50.0, 52.0, 56.0, 57.0, 60.0, 61.0, 63.0, 64.0, 65.0, 67.0, 68.0, 70.0, 73.0, 74.0, 76.0, 78.0, 85.0]",29,19,10,0.3448275862068966,0.6551724137931034
2,2500688,"[10.0, 10.0, 15.0, 24.0, 27.0, 28.0, 30.0, 36.0, 40.0, 41.0, 42.0, 44.0, 45.0, 42.0, 45.0, 51.0, 51.0, 52.0, 57.0, 64.0, 66.0, 67.0, 71.0, 72.0, 76.0, 87.0]",26,13,13,0.5,0.5
3,2500689,"[1.0, 6.0, 7.0, 12.0, 14.0, 15.0, 35.0, 42.0, 46.0, 47.0, 42.0, 45.0, 50.0, 59.0, 60.0, 61.0, 63.0, 76.0]",18,9,9,0.5,0.5
4,2500690,"[6.0, 7.0, 17.0, 19.0, 19.0, 27.0, 33.0, 33.0, 36.0, 38.0, 40.0, 41.0, 44.0, 58.0, 59.0, 67.0, 76.0, 78.0, 78.0, 81.0, 85.0]",21,8,13,0.6190476190476191,0.38095238095238093
5,2500691,"[4.0, 7.0, 7.0, 9.0, 10.0, 13.0, 15.0, 21.0, 23.0, 25.0, 29.0, 36.0, 40.0, 41.0, 43.0, 44.0, 42.0, 42.0, 44.0, 46.0, 51.0, 60.0, 64.0, 70.0, 72.0, 73.0, 74.0, 75.0, 76.0, 80.0, 82.0, 84.0, 86.0, 86.0, 89.0]",35,16,19,0.5428571428571428,0.45714285714285713
6,2500692,"[2.0, 6.0, 10.0, 16.0, 17.0, 23.0, 25.0, 36.0, 37.0, 41.0, 63.0, 65.0, 72.0, 75.0, 77.0, 77.0, 78.0, 85.0, 85.0, 87.0, 90.0]",21,11,10,0.47619047619047616,0.5238095238095238
7,2500693,"[9.0, 11.0, 13.0, 14.0, 28.0, 38.0, 38.0, 44.0, 41.0, 44.0, 48.0, 49.0, 55.0, 61.0, 63.0, 64.0, 72.0, 73.0, 80.0, 84.0, 89.0]",21,11,10,0.47619047619047616,0.5238095238095238
8,2500694,"[2.0, 11.0, 12.0, 20.0, 21.0, 33.0, 44.0, 40.0, 43.0, 45.0, 46.0, 47.0, 47.0, 60.0, 65.0, 77.0, 79.0, 82.0, 85.0]",19,10,9,0.47368421052631576,0.5263157894736842
9,2500695,"[1.0, 6.0, 6.0, 9.0, 13.0, 14.0, 16.0, 19.0, 26.0, 38.0, 40.0, 43.0, 47.0, 48.0, 57.0, 57.0, 58.0, 71.0, 73.0, 76.0, 86.0]",21,9,12,0.5714285714285714,0.42857142857142855
10,2500696,"[8.0, 11.0, 12.0, 14.0, 18.0, 21.0, 21.0, 30.0, 35.0, 38.0, 41.0, 48.0, 48.0, 47.0, 55.0, 58.0, 61.0, 62.0, 63.0, 68.0, 68.0, 73.0, 81.0, 83.0, 83.0, 85.0]",26,15,11,0.4230769230769231,0.5769230769230769
11,2500697,"[0.0, 3.0, 4.0, 5.0, 7.0, 8.0, 11.0, 16.0, 16.0, 22.0, 24.0, 27.0, 29.0, 32.0, 33.0, 33.0, 37.0, 42.0, 46.0, 42.0, 45.0, 48.0, 49.0, 53.0, 54.0, 58.0, 64.0, 79.0]",28,9,19,0.6785714285714286,0.32142857142857145
12,2500698,"[7.0, 9.0, 10.0, 18.0, 21.0, 22.0, 24.0, 26.0, 29.0, 35.0, 39.0, 46.0, 48.0, 48.0, 51.0, 56.0, 60.0, 63.0, 66.0, 69.0, 72.0, 75.0, 77.0, 79.0, 85.0, 87.0]",26,15,11,0.4230769230769231,0.5769230769230769
13,2500699,"[5.0, 8.0, 18.0, 29.0, 31.0, 33.0, 40.0, 41.0, 44.0, 45.0, 49.0, 51.0, 52.0, 56.0, 59.0, 60.0, 63.0, 65.0, 67.0, 69.0, 70.0, 79.0]",22,13,9,0.4090909090909091,0.5909090909090909
14,2500700,"[2.0, 3.0, 5.0, 10.0, 11.0, 18.0, 21.0, 29.0, 31.0, 35.0, 43.0, 44.0, 45.0, 51.0, 59.0, 60.0, 61.0, 62.0, 65.0, 71.0, 73.0, 85.0]",22,10,12,0.5454545454545454,0.45454545454545453
15,2500701,"[2.0, 14.0, 17.0, 25.0, 34.0, 41.0, 43.0, 44.0, 46.0, 47.0, 43.0, 45.0, 50.0, 54.0, 56.0, 59.0, 60.0, 63.0, 73.0, 79.0, 80.0, 85.0, 87.0, 87.0, 89.0]",25,16,9,0.36,0.64
16,2500702,"[2.0, 15.0, 19.0, 26.0, 40.0, 44.0, 50.0, 51.0, 53.0, 56.0, 57.0, 58.0, 61.0, 71.0, 72.0, 78.0, 79.0, 85.0, 89.0]",19,13,6,0.3157894736842105,0.6842105263157895
17,2500703,"[2.0, 3.0, 8.0, 11.0, 14.0, 18.0, 22.0, 23.0, 27.0, 40.0, 45.0, 41.0, 42.0, 43.0, 50.0, 53.0, 57.0, 60.0, 63.0, 64.0, 67.0, 72.0, 76.0, 77.0, 78.0]",25,12,13,0.52,0.48
18,2500704,"[1.0, 6.0, 8.0, 20.0, 23.0, 27.0, 29.0, 32.0, 35.0, 36.0, 39.0, 43.0, 47.0, 50.0, 54.0, 56.0, 57.0, 58.0, 71.0, 75.0, 76.0, 79.0, 86.0]",23,11,12,0.5217391304347826,0.4782608695652174
19,2500705,"[0.0, 1.0, 1.0, 5.0, 6.0, 11.0, 12.0, 15.0, 21.0, 22.0, 28.0, 32.0, 35.0, 37.0, 41.0, 45.0, 49.0, 40.0, 46.0, 47.0, 47.0, 49.0, 51.0, 51.0, 56.0, 58.0, 61.0, 63.0, 65.0, 68.0, 71.0, 76.0, 78.0, 79.0, 80.0, 82.0, 83.0, 87.0]",38,22,16,0.42105263157894735,0.5789473684210527
20,2500706,"[2.0, 8.0, 10.0, 28.0, 29.0, 30.0, 36.0, 37.0, 38.0, 40.0, 41.0, 46.0, 42.0, 56.0, 58.0, 60.0, 62.0, 67.0, 69.0, 72.0, 73.0]",21,9,12,0.5714285714285714,0.42857142857142855
21,2500707,"[4.0, 5.0, 8.0, 11.0, 15.0, 16.0, 21.0, 26.0, 28.0, 32.0, 33.0, 34.0, 35.0, 39.0, 42.0, 43.0, 45.0, 45.0, 45.0, 47.0, 48.0, 48.0, 51.0, 53.0, 53.0, 57.0, 58.0, 61.0, 62.0, 67.0, 71.0, 72.0, 74.0, 77.0, 77.0, 81.0]",36,20,16,0.4444444444444444,0.5555555555555556
22,2500708,"[0.0, 1.0, 3.0, 4.0, 9.0, 12.0, 13.0, 24.0, 26.0, 27.0, 29.0, 30.0, 34.0, 39.0, 44.0, 45.0, 41.0, 50.0, 56.0, 63.0, 71.0, 72.0, 76.0, 80.0, 85.0, 87.0, 87.0, 88.0]",28,12,16,0.5714285714285714,0.42857142857142855
23,2500709,"[2.0, 5.0, 7.0, 14.0, 16.0, 17.0, 20.0, 22.0, 29.0, 32.0, 34.0, 36.0, 38.0, 45.0, 40.0, 43.0, 44.0, 46.0, 49.0, 50.0, 50.0, 52.0, 53.0, 56.0, 57.0, 59.0, 61.0, 66.0, 67.0, 74.0, 80.0, 85.0, 87.0]",33,17,16,0.48484848484848486,0.5151515151515151
24,2500710,"[1.0, 5.0, 7.0, 11.0, 11.0, 14.0, 18.0, 20.0, 27.0, 29.0, 33.0, 34.0, 36.0, 36.0, 38.0, 40.0, 41.0, 44.0, 45.0, 43.0, 59.0, 69.0, 79.0, 79.0, 87.0]",25,6,19,0.76,0.24
25,2500711,"[5.0, 12.0, 14.0, 20.0, 28.0, 36.0, 37.0, 38.0, 41.0, 43.0, 45.0, 48.0, 49.0, 52.0, 54.0, 60.0, 62.0, 62.0, 67.0, 67.0, 68.0, 73.0, 74.0, 77.0, 80.0, 82.0, 88.0]",27,17,10,0.37037037037037035,0.6296296296296297
26,2500712,"[1.0, 2.0, 15.0, 21.0, 22.0, 23.0, 23.0, 27.0, 36.0, 40.0, 40.0, 43.0, 42.0, 47.0, 50.0, 51.0, 53.0, 57.0, 61.0, 62.0, 64.0, 68.0, 71.0, 75.0, 76.0, 83.0, 84.0]",27,14,13,0.48148148148148145,0.5185185185185185
27,2500713,"[1.0, 3.0, 5.0, 16.0, 17.0, 18.0, 22.0, 26.0, 31.0, 32.0, 35.0, 47.0, 51.0, 54.0, 60.0, 63.0, 73.0, 79.0, 82.0, 85.0, 87.0, 88.0]",22,11,11,0.5,0.5
28,2500714,"[1.0, 3.0, 5.0, 7.0, 11.0, 24.0, 29.0, 34.0, 39.0, 41.0, 44.0, 45.0, 46.0, 50.0, 55.0, 55.0, 58.0, 62.0, 63.0, 65.0, 68.0, 71.0, 73.0, 76.0]",24,13,11,0.4583333333333333,0.5416666666666666
29,2500715,"[1.0, 6.0, 13.0, 14.0, 16.0, 22.0, 23.0, 23.0, 25.0, 30.0, 34.0, 53.0, 59.0, 64.0, 73.0, 79.0]",16,5,11,0.6875,0.3125
30,2500716,"[2.0, 2.0, 13.0, 17.0, 23.0, 30.0, 41.0, 44.0, 42.0, 43.0, 45.0, 48.0, 50.0, 52.0, 54.0, 56.0, 61.0, 69.0, 70.0, 72.0, 79.0, 85.0, 87.0]",23,13,10,0.43478260869565216,0.5652173913043478
31,2500717,"[6.0, 8.0, 9.0, 15.0, 16.0, 20.0, 22.0, 22.0, 28.0, 43.0, 44.0, 45.0, 46.0, 52.0, 57.0, 58.0, 66.0, 75.0, 78.0, 80.0, 80.0, 86.0, 88.0]",23,12,11,0.4782608695652174,0.5217391304347826
32,2500718,"[2.0, 13.0, 14.0, 15.0, 20.0, 25.0, 31.0, 34.0, 34.0, 44.0, 46.0, 41.0, 48.0, 50.0, 51.0, 62.0, 64.0, 67.0, 69.0, 72.0, 75.0, 77.0, 79.0, 87.0, 89.0]",25,14,11,0.44,0.56
33,2500719,"[2.0, 3.0, 13.0, 15.0, 17.0, 21.0, 23.0, 24.0, 26.0, 32.0, 40.0, 42.0, 46.0, 46.0, 53.0, 54.0, 59.0, 60.0, 62.0, 67.0, 73.0, 74.0, 75.0, 79.0, 79.0, 83.0, 85.0, 89.0]",28,16,12,0.42857142857142855,0.5714285714285714
34,2500720,"[3.0, 6.0, 9.0, 12.0, 12.0, 16.0, 20.0, 22.0, 25.0, 27.0, 30.0, 32.0, 32.0, 39.0, 42.0, 42.0, 44.0, 50.0, 52.0, 54.0, 57.0, 59.0, 70.0, 72.0, 73.0, 75.0, 78.0, 82.0, 82.0, 85.0, 86.0, 88.0]",32,15,17,0.53125,0.46875
35,2500721,"[0.0, 4.0, 5.0, 7.0, 10.0, 16.0, 18.0, 20.0, 28.0, 30.0, 39.0, 41.0, 43.0, 44.0, 45.0, 45.0, 48.0, 48.0, 54.0, 66.0, 66.0, 71.0, 74.0, 79.0, 86.0, 87.0, 89.0]",27,13,14,0.5185185185185185,0.48148148148148145
36,2500722,"[1.0, 3.0, 3.0, 6.0, 7.0, 11.0, 19.0, 22.0, 24.0, 27.0, 31.0, 33.0, 35.0, 37.0, 42.0, 43.0, 45.0, 46.0, 50.0, 58.0, 65.0, 70.0, 73.0, 76.0, 80.0]",25,9,16,0.64,0.36
37,2500723,"[1.0, 4.0, 7.0, 27.0, 29.0, 31.0, 32.0, 34.0, 37.0, 38.0, 39.0, 41.0, 43.0, 44.0, 45.0, 48.0, 51.0, 62.0, 69.0, 70.0, 75.0, 81.0, 85.0, 86.0]",24,10,14,0.5833333333333334,0.4166666666666667
38,2500724,"[4.0, 9.0, 13.0, 14.0, 18.0, 23.0, 27.0, 29.0, 31.0, 32.0, 34.0, 34.0, 38.0, 45.0, 44.0, 44.0, 47.0, 47.0, 51.0, 53.0, 59.0, 63.0, 65.0, 69.0, 73.0, 74.0, 76.0, 79.0, 80.0, 82.0, 87.0, 88.0]",32,17,15,0.46875,0.53125
39,2500725,"[1.0, 2.0, 3.0, 6.0, 7.0, 9.0, 9.0, 12.0, 15.0, 20.0, 25.0, 25.0, 28.0, 33.0, 35.0, 36.0, 38.0, 41.0, 43.0, 45.0, 46.0, 40.0, 42.0, 43.0, 43.0, 44.0, 44.0, 46.0, 46.0, 51.0, 56.0, 60.0, 62.0, 64.0, 64.0, 68.0, 68.0, 69.0, 76.0, 78.0, 80.0, 81.0, 89.0]",43,18,25,0.5813953488372093,0.4186046511627907
40,2500726,"[3.0, 5.0, 11.0, 17.0, 17.0, 18.0, 31.0, 39.0, 41.0, 43.0, 45.0, 41.0, 46.0, 48.0, 49.0, 50.0, 53.0, 56.0, 57.0, 58.0, 59.0, 60.0, 61.0, 65.0, 66.0, 70.0, 73.0, 76.0, 77.0, 79.0, 82.0, 83.0, 84.0, 85.0, 87.0, 88.0]",36,25,11,0.3055555555555556,0.6944444444444444
41,2500727,"[2.0, 3.0, 4.0, 13.0, 14.0, 17.0, 23.0, 31.0, 35.0, 39.0, 43.0, 44.0, 48.0, 41.0, 44.0, 47.0, 58.0, 59.0, 61.0, 67.0, 69.0, 77.0, 79.0, 80.0, 81.0]",25,11,14,0.56,0.44
42,2500728,"[1.0, 4.0, 4.0, 7.0, 8.0, 15.0, 20.0, 22.0, 26.0, 28.0, 30.0, 32.0, 33.0, 35.0, 43.0, 43.0, 51.0, 55.0, 55.0, 56.0, 57.0, 63.0, 69.0, 69.0, 70.0, 71.0, 72.0, 73.0, 76.0, 78.0, 81.0, 82.0, 83.0, 87.0]",34,18,16,0.47058823529411764,0.5294117647058824
43,2500729,"[0.0, 1.0, 5.0, 7.0, 13.0, 14.0, 16.0, 23.0, 25.0, 26.0, 29.0, 31.0, 34.0, 35.0, 37.0, 42.0, 43.0, 45.0, 45.0, 48.0, 50.0, 55.0, 56.0, 60.0, 62.0, 63.0, 65.0, 71.0, 77.0, 77.0, 78.0, 83.0, 85.0]",33,16,17,0.5151515151515151,0.48484848484848486
44,2500730,"[2.0, 12.0, 16.0, 19.0, 20.0, 27.0, 27.0, 30.0, 32.0, 33.0, 37.0, 38.0, 40.0, 49.0, 50.0, 84.0, 85.0, 85.0]",18,5,13,0.7222222222222222,0.2777777777777778
45,2500731,"[3.0, 19.0, 27.0, 33.0, 36.0, 40.0, 41.0, 43.0, 55.0, 62.0, 62.0, 63.0, 69.0, 77.0, 78.0, 81.0, 84.0, 87.0, 89.0]",19,11,8,0.42105263157894735,0.5789473684210527
46,2500732,"[0.0, 3.0, 4.0, 11.0, 13.0, 22.0, 23.0, 27.0, 29.0, 31.0, 35.0, 38.0, 39.0, 40.0, 43.0, 43.0, 50.0, 51.0, 52.0, 58.0, 59.0, 62.0, 66.0, 70.0, 70.0, 71.0, 72.0, 75.0, 77.0, 82.0, 83.0, 84.0, 84.0]",33,17,16,0.48484848484848486,0.5151515151515151
47,2500733,"[2.0, 3.0, 4.0, 4.0, 6.0, 6.0, 10.0, 12.0, 14.0, 18.0, 23.0, 26.0, 29.0, 33.0, 37.0, 39.0, 42.0, 43.0, 41.0, 54.0, 56.0, 68.0, 71.0, 73.0, 78.0, 80.0, 83.0]",27,8,19,0.7037037037037037,0.2962962962962963
48,2500734,"[5.0, 8.0, 10.0, 15.0, 16.0, 17.0, 18.0, 21.0, 22.0, 23.0, 23.0, 24.0, 26.0, 39.0, 42.0, 45.0, 41.0, 41.0, 43.0, 49.0, 50.0, 52.0, 53.0, 54.0, 55.0, 55.0, 56.0, 58.0, 59.0, 61.0, 62.0, 69.0, 70.0, 72.0, 75.0, 79.0]",36,18,18,0.5,0.5
49,2500735,"[3.0, 5.0, 5.0, 6.0, 9.0, 16.0, 17.0, 18.0, 19.0, 29.0, 30.0, 31.0, 33.0, 45.0, 46.0, 42.0, 54.0, 61.0, 63.0, 65.0, 67.0, 76.0, 78.0, 79.0, 81.0, 85.0, 85.0]",27,13,14,0.5185185185185185,0.48148148148148145
50,2500736,"[0.0, 1.0, 3.0, 7.0, 10.0, 10.0, 13.0, 16.0, 19.0, 21.0, 31.0, 34.0, 37.0, 39.0, 40.0, 45.0, 49.0, 54.0, 57.0, 64.0, 64.0, 75.0, 78.0, 79.0, 81.0, 82.0, 89.0]",27,12,15,0.5555555555555556,0.4444444444444444
51,2500737,"[1.0, 8.0, 11.0, 12.0, 14.0, 31.0, 33.0, 35.0, 43.0, 44.0, 40.0, 42.0, 43.0, 53.0, 55.0, 57.0, 62.0, 64.0, 67.0, 69.0, 71.0, 73.0, 79.0, 80.0, 83.0, 86.0, 88.0, 90.0, 90.0]",29,16,13,0.4482758620689655,0.5517241379310345
52,2500738,"[6.0, 7.0, 12.0, 14.0, 18.0, 19.0, 21.0, 23.0, 25.0, 26.0, 31.0, 33.0, 38.0, 42.0, 42.0, 47.0, 50.0, 52.0, 58.0, 60.0, 67.0, 71.0, 73.0, 73.0, 75.0, 83.0, 88.0]",27,12,15,0.5555555555555556,0.4444444444444444
53,2500739,"[1.0, 6.0, 10.0, 11.0, 12.0, 12.0, 17.0, 23.0, 27.0, 29.0, 31.0, 34.0, 49.0, 51.0, 53.0, 63.0, 65.0, 68.0, 73.0, 74.0, 74.0, 75.0, 78.0, 79.0, 81.0, 84.0, 84.0]",27,15,12,0.4444444444444444,0.5555555555555556
54,2500740,"[0.0, 3.0, 4.0, 6.0, 8.0, 9.0, 14.0, 24.0, 26.0, 28.0, 36.0, 45.0, 50.0, 53.0, 57.0, 57.0, 59.0, 60.0, 67.0, 70.0, 78.0, 78.0, 81.0, 81.0, 84.0]",25,14,11,0.44,0.56
55,2500741,"[2.0, 6.0, 9.0, 12.0, 16.0, 23.0, 24.0, 26.0, 34.0, 45.0, 47.0, 53.0, 57.0, 59.0, 60.0, 64.0, 64.0, 70.0, 72.0, 74.0, 78.0, 81.0, 82.0, 85.0, 85.0, 88.0]",26,17,9,0.34615384615384615,0.6538461538461539
56,2500742,"[0.0, 8.0, 11.0, 13.0, 18.0, 19.0, 21.0, 26.0, 31.0, 34.0, 36.0, 38.0, 39.0, 40.0, 44.0, 43.0, 48.0, 50.0, 59.0, 62.0, 67.0, 71.0, 72.0, 73.0, 76.0, 79.0, 86.0]",27,11,16,0.5925925925925926,0.4074074074074074
57,2500743,"[1.0, 5.0, 8.0, 13.0, 23.0, 26.0, 29.0, 34.0, 35.0, 40.0, 42.0, 44.0, 47.0, 43.0, 46.0, 51.0, 54.0, 55.0, 56.0, 57.0, 61.0, 63.0, 64.0, 66.0, 69.0, 78.0, 80.0, 81.0, 82.0, 82.0, 84.0, 86.0, 87.0]",33,20,13,0.3939393939393939,0.6060606060606061
58,2500744,"[3.0, 5.0, 8.0, 9.0, 12.0, 19.0, 22.0, 26.0, 34.0, 38.0, 41.0, 47.0, 48.0, 52.0, 55.0, 56.0, 59.0, 60.0, 60.0, 65.0, 68.0, 69.0, 76.0, 80.0, 81.0, 84.0, 86.0, 86.0]",28,17,11,0.39285714285714285,0.6071428571428571
59,2500745,"[6.0, 9.0, 11.0, 19.0, 34.0, 36.0, 38.0, 38.0, 39.0, 40.0, 42.0, 43.0, 41.0, 43.0, 46.0, 48.0, 51.0, 65.0, 66.0, 67.0, 71.0, 74.0, 76.0, 76.0, 77.0, 77.0, 79.0, 80.0, 81.0, 90.0]",30,16,14,0.4666666666666667,0.5333333333333333
60,2500746,"[2.0, 4.0, 9.0, 11.0, 17.0, 19.0, 28.0, 35.0, 36.0, 38.0, 39.0, 41.0, 41.0, 43.0, 44.0, 45.0, 45.0, 46.0, 50.0, 51.0, 55.0, 56.0, 61.0, 66.0, 68.0, 74.0, 79.0, 85.0]",28,13,15,0.5357142857142857,0.4642857142857143
61,2500747,"[4.0, 7.0, 10.0, 12.0, 13.0, 16.0, 16.0, 19.0, 22.0, 23.0, 31.0, 34.0, 40.0, 45.0, 43.0, 47.0, 50.0, 51.0, 52.0, 52.0, 53.0, 53.0, 56.0, 62.0, 64.0, 68.0, 68.0, 69.0, 70.0, 74.0, 78.0, 79.0, 81.0, 82.0]",34,20,14,0.4117647058823529,0.5882352941176471
62,2500748,"[3.0, 4.0, 9.0, 12.0, 14.0, 18.0, 21.0, 21.0, 25.0, 27.0, 28.0, 32.0, 35.0, 36.0, 43.0, 44.0, 41.0, 41.0, 46.0, 53.0, 54.0, 55.0, 55.0, 57.0, 60.0, 63.0, 67.0, 73.0, 77.0, 78.0, 81.0, 83.0, 83.0]",33,15,18,0.5454545454545454,0.45454545454545453
63,2500749,"[2.0, 6.0, 7.0, 15.0, 16.0, 21.0, 22.0, 22.0, 25.0, 32.0, 34.0, 35.0, 36.0, 37.0, 40.0, 45.0, 47.0, 45.0, 47.0, 50.0, 51.0, 53.0, 54.0, 56.0, 59.0, 67.0, 67.0, 69.0, 73.0, 76.0, 78.0, 79.0, 81.0, 82.0, 83.0, 85.0, 88.0]",37,22,15,0.40540540540540543,0.5945945945945946
64,2500750,"[10.0, 11.0, 16.0, 19.0, 24.0, 36.0, 38.0, 42.0, 43.0, 44.0, 47.0, 48.0, 54.0, 59.0, 67.0, 69.0, 71.0, 76.0, 78.0, 81.0, 87.0]",21,11,10,0.47619047619047616,0.5238095238095238
65,2500751,"[5.0, 12.0, 18.0, 20.0, 20.0, 28.0, 31.0, 37.0, 41.0, 41.0, 43.0, 50.0, 54.0, 57.0, 61.0, 68.0, 72.0, 73.0, 76.0, 81.0, 81.0, 84.0, 87.0, 88.0]",24,13,11,0.4583333333333333,0.5416666666666666
66,2500752,"[6.0, 7.0, 9.0, 11.0, 12.0, 13.0, 24.0, 30.0, 35.0, 36.0, 37.0, 41.0, 46.0, 42.0, 43.0, 44.0, 46.0, 49.0, 56.0, 61.0, 68.0, 70.0, 75.0, 76.0, 78.0, 78.0, 82.0, 86.0, 87.0]",29,14,15,0.5172413793103449,0.4827586206896552
67,2500753,"[3.0, 5.0, 7.0, 11.0, 18.0, 19.0, 21.0, 21.0, 24.0, 38.0, 40.0, 41.0, 40.0, 41.0, 45.0, 46.0, 53.0, 56.0, 57.0, 61.0, 63.0, 64.0, 66.0, 68.0, 69.0, 74.0, 77.0, 78.0, 81.0, 87.0]",30,16,14,0.4666666666666667,0.5333333333333333
68,2500754,"[0.0, 3.0, 12.0, 19.0, 23.0, 29.0, 33.0, 33.0, 39.0, 45.0, 46.0, 52.0, 53.0, 57.0, 58.0, 60.0, 61.0, 63.0, 64.0, 69.0, 70.0, 75.0, 83.0, 84.0, 84.0, 89.0]",26,17,9,0.34615384615384615,0.6538461538461539
69,2500755,"[11.0, 14.0, 15.0, 16.0, 17.0, 21.0, 40.0, 41.0, 43.0, 54.0, 62.0, 76.0]",12,3,9,0.75,0.25
70,2500756,"[1.0, 3.0, 5.0, 16.0, 21.0, 22.0, 23.0, 32.0, 42.0, 46.0, 46.0, 49.0, 53.0, 54.0, 55.0, 57.0, 58.0, 67.0, 72.0, 72.0, 73.0, 76.0, 79.0, 84.0]",24,15,9,0.375,0.625
71,2500757,"[0.0, 3.0, 23.0, 25.0, 27.0, 28.0, 31.0, 42.0, 44.0, 44.0, 50.0, 50.0, 54.0, 57.0, 59.0, 65.0, 66.0, 72.0, 73.0, 77.0, 78.0, 80.0, 81.0, 83.0, 86.0, 87.0, 87.0]",27,17,10,0.37037037037037035,0.6296296296296297
72,2500758,"[1.0, 4.0, 11.0, 25.0, 27.0, 28.0, 31.0, 39.0, 40.0, 43.0, 45.0, 47.0, 48.0, 52.0, 60.0, 61.0, 64.0, 64.0, 69.0, 72.0, 79.0, 81.0, 84.0, 85.0, 88.0, 89.0, 89.0]",27,17,10,0.37037037037037035,0.6296296296296297
73,2500759,"[5.0, 12.0, 14.0, 16.0, 20.0, 22.0, 23.0, 28.0, 28.0, 30.0, 33.0, 34.0, 35.0, 37.0, 41.0, 44.0, 43.0, 46.0, 47.0, 50.0, 51.0, 52.0, 53.0, 53.0, 55.0, 57.0, 62.0, 63.0, 67.0, 69.0, 70.0, 77.0, 84.0, 86.0, 87.0]",35,18,17,0.4857142857142857,0.5142857142857142
74,2500760,"[4.0, 10.0, 11.0, 17.0, 18.0, 21.0, 23.0, 25.0, 26.0, 31.0, 35.0, 41.0, 44.0, 44.0, 41.0, 44.0, 45.0, 46.0, 47.0, 48.0, 49.0, 50.0, 59.0, 60.0, 70.0, 72.0, 79.0, 83.0, 85.0, 85.0, 89.0, 90.0]",32,16,16,0.5,0.5
75,2500761,"[6.0, 11.0, 20.0, 25.0, 28.0, 37.0, 42.0, 41.0, 45.0, 46.0, 52.0, 56.0, 57.0, 60.0, 64.0, 75.0, 77.0, 80.0, 81.0, 84.0, 84.0, 86.0, 87.0, 90.0]",24,16,8,0.3333333333333333,0.6666666666666666
76,2500762,"[0.0, 1.0, 2.0, 3.0, 7.0, 7.0, 10.0, 12.0, 13.0, 18.0, 22.0, 26.0, 31.0, 35.0, 36.0, 41.0, 44.0, 46.0, 50.0, 51.0, 52.0, 54.0, 55.0, 58.0, 61.0, 66.0, 70.0, 76.0, 81.0, 83.0]",30,13,17,0.5666666666666667,0.43333333333333335
77,2500763,"[2.0, 4.0, 10.0, 11.0, 16.0, 20.0, 24.0, 25.0, 26.0, 26.0, 26.0, 37.0, 39.0, 39.0, 43.0, 43.0, 46.0, 44.0, 45.0, 50.0, 51.0, 55.0, 57.0, 58.0, 72.0, 76.0, 78.0, 83.0, 86.0]",29,12,17,0.5862068965517241,0.41379310344827586
78,2500764,"[1.0, 6.0, 8.0, 9.0, 13.0, 14.0, 15.0, 16.0, 16.0, 17.0, 18.0, 21.0, 22.0, 23.0, 24.0, 26.0, 29.0, 31.0, 32.0, 36.0, 42.0, 44.0, 45.0, 46.0, 47.0, 42.0, 45.0, 50.0, 55.0, 57.0, 65.0, 67.0, 70.0, 74.0, 77.0, 80.0, 82.0, 83.0, 85.0]",39,16,23,0.5897435897435898,0.41025641025641024
79,2500765,"[4.0, 18.0, 25.0, 28.0, 30.0, 33.0, 37.0, 43.0, 44.0, 48.0, 50.0, 51.0, 64.0, 67.0, 69.0, 71.0, 72.0, 73.0, 74.0, 78.0, 81.0, 81.0, 82.0, 83.0, 83.0, 84.0, 88.0]",27,18,9,0.3333333333333333,0.6666666666666666
80,2500766,"[7.0, 11.0, 12.0, 12.0, 16.0, 18.0, 21.0, 24.0, 25.0, 26.0, 27.0, 28.0, 33.0, 40.0, 41.0, 44.0, 45.0, 54.0, 56.0, 57.0, 58.0, 59.0, 60.0, 60.0, 66.0, 68.0, 70.0, 72.0, 79.0, 81.0]",30,14,16,0.5333333333333333,0.4666666666666667
81,2500767,"[1.0, 2.0, 9.0, 12.0, 13.0, 19.0, 24.0, 25.0, 28.0, 31.0, 36.0, 39.0, 41.0, 44.0, 42.0, 46.0, 52.0, 54.0, 55.0, 60.0, 61.0, 68.0, 69.0, 75.0, 76.0, 77.0, 79.0, 83.0, 84.0]",29,14,15,0.5172413793103449,0.4827586206896552
82,2500768,"[6.0, 8.0, 20.0, 31.0, 39.0, 40.0, 41.0, 43.0, 45.0, 41.0, 42.0, 45.0, 46.0, 52.0, 67.0, 70.0, 71.0, 75.0, 75.0, 77.0, 79.0, 80.0, 83.0, 84.0, 88.0]",25,15,10,0.4,0.6
83,2500769,"[1.0, 3.0, 4.0, 7.0, 9.0, 13.0, 14.0, 16.0, 19.0, 19.0, 20.0, 24.0, 26.0, 26.0, 27.0, 30.0, 31.0, 36.0, 38.0, 46.0, 40.0, 46.0, 49.0, 51.0, 56.0, 57.0, 60.0, 60.0, 63.0, 64.0, 67.0, 72.0, 73.0, 76.0, 80.0, 81.0, 88.0]",37,17,20,0.5405405405405406,0.4594594594594595
84,2500770,"[4.0, 6.0, 10.0, 13.0, 14.0, 21.0, 25.0, 32.0, 37.0, 42.0, 43.0, 41.0, 41.0, 44.0, 46.0, 47.0, 47.0, 52.0, 59.0, 60.0, 63.0, 71.0, 73.0, 78.0, 80.0, 83.0, 84.0, 85.0, 86.0]",29,15,14,0.4827586206896552,0.5172413793103449
85,2500771,"[1.0, 4.0, 6.0, 10.0, 12.0, 15.0, 15.0, 26.0, 32.0, 38.0, 45.0, 43.0, 46.0, 46.0, 47.0, 49.0, 56.0, 63.0, 64.0, 65.0, 75.0, 83.0, 85.0, 86.0, 88.0, 88.0, 89.0]",27,16,11,0.4074074074074074,0.5925925925925926
86,2500772,"[8.0, 9.0, 12.0, 14.0, 17.0, 21.0, 28.0, 30.0, 32.0, 37.0, 41.0, 42.0, 44.0, 46.0, 47.0, 49.0, 51.0, 56.0, 59.0, 62.0, 63.0, 70.0, 72.0, 74.0, 80.0, 81.0, 81.0, 86.0, 87.0, 87.0]",30,17,13,0.43333333333333335,0.5666666666666667
87,2500773,"[6.0, 10.0, 12.0, 14.0, 15.0, 17.0, 21.0, 23.0, 27.0, 29.0, 30.0, 35.0, 42.0, 44.0, 45.0, 54.0, 55.0, 59.0, 63.0, 69.0, 70.0, 70.0, 73.0, 75.0, 78.0, 84.0, 86.0]",27,13,14,0.5185185185185185,0.48148148148148145
88,2500774,"[10.0, 14.0, 15.0, 21.0, 22.0, 22.0, 23.0, 25.0, 26.0, 29.0, 38.0, 39.0, 44.0, 43.0, 51.0, 56.0, 60.0, 61.0, 76.0, 77.0, 77.0, 83.0, 83.0, 84.0, 84.0, 86.0]",26,12,14,0.5384615384615384,0.46153846153846156
89,2500775,"[1.0, 8.0, 11.0, 14.0, 16.0, 18.0, 20.0, 21.0, 30.0, 35.0, 36.0, 38.0, 39.0, 41.0, 42.0, 44.0, 46.0, 47.0, 48.0, 54.0, 55.0, 57.0, 60.0, 61.0, 65.0, 66.0, 73.0, 77.0, 81.0, 82.0, 83.0, 83.0, 86.0, 87.0, 89.0, 89.0]",36,20,16,0.4444444444444444,0.5555555555555556
90,2500776,"[11.0, 13.0, 16.0, 16.0, 22.0, 25.0, 26.0, 31.0, 36.0, 44.0, 45.0, 44.0, 50.0, 53.0, 56.0, 61.0, 63.0, 65.0, 68.0, 71.0, 72.0, 76.0, 76.0, 78.0, 81.0, 86.0]",26,15,11,0.4230769230769231,0.5769230769230769
91,2500777,"[1.0, 3.0, 5.0, 6.0, 9.0, 10.0, 13.0, 14.0, 15.0, 17.0, 19.0, 37.0, 40.0, 42.0, 55.0, 55.0, 59.0, 61.0, 62.0, 64.0, 66.0, 68.0, 71.0, 74.0, 77.0, 78.0, 81.0, 85.0, 86.0]",29,15,14,0.4827586206896552,0.5172413793103449
92,2500778,"[4.0, 5.0, 7.0, 18.0, 19.0, 21.0, 26.0, 27.0, 28.0, 31.0, 32.0, 36.0, 41.0, 43.0, 45.0, 43.0, 43.0, 46.0, 48.0, 50.0, 55.0, 57.0, 60.0, 61.0, 67.0, 77.0, 78.0, 79.0, 80.0, 81.0, 81.0, 83.0, 85.0, 85.0, 86.0, 89.0]",36,20,16,0.4444444444444444,0.5555555555555556
93,2500779,"[7.0, 10.0, 12.0, 18.0, 19.0, 22.0, 24.0, 26.0, 39.0, 43.0, 44.0, 46.0, 47.0, 51.0, 53.0, 56.0, 57.0, 64.0, 66.0, 71.0, 77.0, 79.0, 81.0, 85.0, 87.0, 89.0]",26,15,11,0.4230769230769231,0.5769230769230769
94,2500780,"[1.0, 2.0, 24.0, 24.0, 26.0, 28.0, 37.0, 42.0, 42.0, 43.0, 44.0, 42.0, 44.0, 47.0, 48.0, 51.0, 53.0, 55.0, 56.0, 57.0, 59.0, 62.0, 74.0, 78.0, 80.0, 82.0, 83.0, 85.0, 86.0]",29,16,13,0.4482758620689655,0.5517241379310345
95,2500781,"[5.0, 7.0, 8.0, 13.0, 16.0, 17.0, 19.0, 24.0, 25.0, 28.0, 32.0, 34.0, 43.0, 44.0, 45.0, 42.0, 43.0, 43.0, 45.0, 48.0, 56.0, 66.0, 79.0, 80.0, 86.0, 87.0]",26,9,17,0.6538461538461539,0.34615384615384615
96,2500782,"[5.0, 7.0, 14.0, 41.0, 47.0, 50.0, 50.0, 52.0, 52.0, 56.0, 61.0, 81.0, 89.0]",13,9,4,0.3076923076923077,0.6923076923076923
97,2500783,"[0.0, 1.0, 1.0, 10.0, 15.0, 16.0, 18.0, 19.0, 22.0, 30.0, 31.0, 34.0, 35.0, 37.0, 42.0, 47.0, 49.0, 52.0, 63.0, 66.0, 70.0, 71.0, 72.0, 73.0, 79.0, 82.0, 84.0, 88.0, 88.0, 90.0]",30,15,15,0.5,0.5
98,2500784,"[4.0, 5.0, 6.0, 9.0, 9.0, 10.0, 11.0, 13.0, 15.0, 16.0, 23.0, 24.0, 26.0, 31.0, 32.0, 34.0, 34.0, 39.0, 42.0, 42.0, 44.0, 47.0, 41.0, 43.0, 43.0, 46.0, 48.0, 48.0, 54.0, 57.0, 59.0, 62.0, 65.0, 68.0, 70.0, 70.0, 72.0, 73.0, 78.0, 81.0, 82.0, 85.0]",42,18,24,0.5714285714285714,0.42857142857142855
99,2500785,"[6.0, 8.0, 9.0, 10.0, 12.0, 15.0, 17.0, 18.0, 20.0, 24.0, 25.0, 26.0, 30.0, 31.0, 32.0, 33.0, 40.0, 43.0, 45.0, 53.0, 57.0, 61.0, 63.0, 73.0, 78.0, 80.0]",26,8,18,0.6923076923076923,0.3076923076923077
100,2500786,"[1.0, 2.0, 3.0, 5.0, 5.0, 7.0, 8.0, 13.0, 16.0, 26.0, 28.0, 30.0, 31.0, 32.0, 36.0, 39.0, 41.0, 45.0, 42.0, 43.0, 46.0, 49.0, 50.0, 53.0, 56.0, 61.0, 63.0, 65.0, 70.0, 71.0, 72.0, 79.0, 81.0, 86.0]",34,15,19,0.5588235294117647,0.4411764705882353
101,2500787,"[4.0, 5.0, 9.0, 13.0, 15.0, 20.0, 23.0, 25.0, 36.0, 41.0, 40.0, 42.0, 46.0, 55.0, 60.0, 62.0, 64.0, 68.0, 72.0, 75.0, 76.0, 83.0, 84.0, 86.0, 88.0]",25,13,12,0.48,0.52
102,2500788,"[4.0, 5.0, 9.0, 12.0, 16.0, 21.0, 22.0, 25.0, 27.0, 29.0, 43.0, 45.0, 48.0, 51.0, 53.0, 54.0, 56.0, 56.0, 58.0, 59.0, 59.0, 61.0, 64.0, 64.0, 65.0, 67.0, 68.0, 72.0, 76.0, 77.0, 78.0, 79.0, 80.0, 80.0, 81.0, 85.0]",36,25,11,0.3055555555555556,0.6944444444444444
103,2500789,"[1.0, 4.0, 6.0, 7.0, 11.0, 13.0, 16.0, 17.0, 18.0, 19.0, 20.0, 21.0, 24.0, 28.0, 30.0, 35.0, 36.0, 36.0, 38.0, 41.0, 40.0, 42.0, 48.0, 51.0, 52.0, 57.0, 65.0, 70.0, 73.0, 74.0, 76.0, 79.0, 79.0, 82.0, 83.0, 85.0, 88.0, 89.0]",38,16,22,0.5789473684210527,0.42105263157894735
104,2500790,"[1.0, 4.0, 7.0, 8.0, 9.0, 10.0, 11.0, 13.0, 14.0, 17.0, 20.0, 24.0, 25.0, 32.0, 34.0, 36.0, 36.0, 37.0, 39.0, 40.0, 44.0, 44.0, 45.0, 46.0, 48.0, 51.0, 52.0, 54.0, 64.0, 67.0, 79.0, 82.0, 84.0, 86.0, 89.0]",35,13,22,0.6285714285714286,0.37142857142857144
105,2500791,"[3.0, 13.0, 14.0, 14.0, 21.0, 23.0, 27.0, 28.0, 29.0, 31.0, 38.0, 40.0, 41.0, 42.0, 42.0, 42.0, 45.0, 47.0, 56.0, 57.0, 59.0, 64.0, 64.0, 70.0, 74.0, 75.0, 78.0, 81.0, 85.0, 85.0]",30,14,16,0.5333333333333333,0.4666666666666667
106,2500792,"[2.0, 3.0, 6.0, 8.0, 19.0, 21.0, 22.0, 24.0, 26.0, 38.0, 38.0, 41.0, 45.0, 41.0, 44.0, 45.0, 47.0, 48.0, 49.0, 49.0, 54.0, 55.0, 56.0, 57.0, 60.0, 72.0, 78.0, 80.0, 87.0, 88.0, 90.0, 92.0]",32,18,14,0.4375,0.5625
107,2500793,"[0.0, 1.0, 2.0, 7.0, 10.0, 26.0, 27.0, 45.0, 49.0, 53.0, 58.0, 58.0, 63.0, 68.0, 70.0, 71.0, 71.0, 72.0, 84.0]",19,12,7,0.3684210526315789,0.631578947368421
108,2500794,"[7.0, 13.0, 17.0, 18.0, 22.0, 25.0, 26.0, 32.0, 33.0, 40.0, 47.0, 48.0, 50.0, 57.0, 58.0, 65.0, 67.0, 74.0, 77.0, 83.0, 84.0, 86.0]",22,12,10,0.45454545454545453,0.5454545454545454
109,2500795,"[5.0, 5.0, 9.0, 12.0, 13.0, 15.0, 16.0, 23.0, 24.0, 30.0, 31.0, 33.0, 36.0, 36.0, 38.0, 40.0, 44.0, 46.0, 40.0, 43.0, 45.0, 47.0, 48.0, 50.0, 51.0, 55.0, 56.0, 57.0, 58.0, 59.0, 60.0, 62.0, 66.0, 69.0, 73.0, 74.0, 75.0, 87.0]",38,19,19,0.5,0.5
110,2500796,"[1.0, 1.0, 10.0, 20.0, 23.0, 26.0, 35.0, 40.0, 43.0, 45.0, 48.0, 51.0, 51.0, 52.0, 58.0, 59.0, 63.0, 64.0, 69.0, 75.0, 85.0]",21,12,9,0.42857142857142855,0.5714285714285714
111,2500797,"[5.0, 8.0, 26.0, 28.0, 31.0, 33.0, 39.0, 41.0, 58.0, 66.0, 74.0, 75.0, 77.0, 85.0]",14,6,8,0.5714285714285714,0.42857142857142855
112,2500798,"[2.0, 6.0, 9.0, 12.0, 17.0, 18.0, 20.0, 22.0, 26.0, 27.0, 30.0, 32.0, 34.0, 36.0, 38.0, 41.0, 42.0, 44.0, 45.0, 41.0, 42.0, 46.0, 54.0, 55.0, 56.0, 60.0, 60.0, 69.0, 74.0, 77.0, 80.0, 80.0, 83.0]",33,13,20,0.6060606060606061,0.3939393939393939
113,2500799,"[5.0, 6.0, 11.0, 12.0, 13.0, 20.0, 24.0, 29.0, 31.0, 32.0, 33.0, 41.0, 43.0, 44.0, 45.0, 42.0, 47.0, 47.0, 56.0, 57.0, 65.0, 69.0, 77.0, 82.0, 83.0, 83.0]",26,11,15,0.5769230769230769,0.4230769230769231
114,2500800,"[6.0, 6.0, 9.0, 14.0, 24.0, 26.0, 31.0, 31.0, 37.0, 37.0, 46.0, 47.0, 48.0, 56.0, 60.0, 62.0, 64.0, 75.0, 78.0, 79.0, 84.0, 86.0, 87.0]",23,13,10,0.43478260869565216,0.5652173913043478
115,2500801,"[2.0, 3.0, 11.0, 13.0, 14.0, 17.0, 20.0, 21.0, 22.0, 23.0, 30.0, 31.0, 33.0, 34.0, 36.0, 39.0, 40.0, 42.0, 44.0, 42.0, 44.0, 44.0, 49.0, 51.0, 51.0, 53.0, 53.0, 57.0, 58.0, 59.0, 69.0, 74.0, 76.0, 78.0, 79.0, 83.0, 86.0]",37,15,22,0.5945945945945946,0.40540540540540543
116,2500802,"[2.0, 6.0, 9.0, 12.0, 20.0, 27.0, 30.0, 36.0, 38.0, 41.0, 40.0, 41.0, 47.0, 54.0, 56.0, 60.0, 64.0, 76.0, 77.0, 78.0, 81.0, 83.0, 85.0]",23,11,12,0.5217391304347826,0.4782608695652174
117,2500803,"[4.0, 5.0, 7.0, 8.0, 10.0, 13.0, 22.0, 26.0, 29.0, 30.0, 31.0, 32.0, 33.0, 41.0, 43.0, 44.0, 45.0, 45.0, 47.0, 40.0, 41.0, 41.0, 45.0, 55.0, 56.0, 62.0, 64.0, 66.0, 67.0, 71.0, 72.0, 74.0, 76.0, 76.0, 79.0, 81.0, 85.0, 85.0, 87.0, 88.0]",40,21,19,0.475,0.525
118,2500804,"[0.0, 8.0, 14.0, 14.0, 15.0, 15.0, 22.0, 23.0, 28.0, 31.0, 31.0, 32.0, 35.0, 36.0, 36.0, 38.0, 43.0, 46.0, 48.0, 50.0, 42.0, 44.0, 44.0, 46.0, 48.0, 49.0, 50.0, 51.0, 53.0, 54.0, 65.0, 66.0, 69.0, 71.0, 77.0, 80.0, 82.0, 83.0, 84.0, 85.0]",40,20,20,0.5,0.5
119,2500805,"[1.0, 5.0, 8.0, 10.0, 11.0, 15.0, 19.0, 23.0, 23.0, 23.0, 24.0, 25.0, 29.0, 29.0, 32.0, 34.0, 39.0, 40.0, 42.0, 44.0, 44.0, 42.0, 53.0, 63.0, 70.0, 73.0, 75.0, 84.0]",28,6,22,0.7857142857142857,0.21428571428571427
120,2500806,"[0.0, 1.0, 2.0, 3.0, 8.0, 9.0, 10.0, 11.0, 19.0, 20.0, 21.0, 23.0, 25.0, 27.0, 32.0, 32.0, 36.0, 37.0, 42.0, 45.0, 50.0, 58.0, 59.0, 64.0, 67.0, 70.0, 74.0, 85.0, 87.0, 88.0, 88.0, 88.0]",32,13,19,0.59375,0.40625
121,2500807,"[0.0, 5.0, 7.0, 8.0, 15.0, 21.0, 27.0, 33.0, 37.0, 38.0, 45.0, 45.0, 41.0, 42.0, 43.0, 45.0, 48.0, 50.0, 51.0, 54.0, 54.0, 58.0, 59.0, 61.0, 62.0, 67.0, 74.0, 77.0, 86.0, 88.0]",30,17,13,0.43333333333333335,0.5666666666666667
122,2500808,"[5.0, 17.0, 18.0, 20.0, 22.0, 22.0, 24.0, 29.0, 37.0, 42.0, 43.0, 49.0, 55.0, 57.0, 58.0, 59.0, 64.0, 66.0, 70.0, 72.0, 76.0, 77.0, 78.0]",23,12,11,0.4782608695652174,0.5217391304347826
123,2500809,"[3.0, 5.0, 7.0, 8.0, 9.0, 12.0, 14.0, 15.0, 19.0, 20.0, 28.0, 30.0, 37.0, 39.0, 47.0, 54.0, 55.0, 62.0, 67.0, 70.0, 76.0, 79.0, 80.0, 83.0, 86.0]",25,11,14,0.56,0.44
124,2500810,"[1.0, 2.0, 5.0, 9.0, 16.0, 24.0, 25.0, 26.0, 34.0, 40.0, 42.0, 43.0, 46.0, 41.0, 48.0, 51.0, 52.0, 53.0, 53.0, 54.0, 56.0, 61.0, 62.0, 63.0, 65.0, 70.0, 72.0, 77.0, 78.0, 83.0, 85.0, 86.0, 89.0]",33,20,13,0.3939393939393939,0.6060606060606061
125,2500811,"[11.0, 13.0, 15.0, 18.0, 21.0, 22.0, 25.0, 27.0, 28.0, 35.0, 41.0, 42.0, 44.0, 46.0, 42.0, 46.0, 47.0, 48.0, 51.0, 53.0, 56.0, 60.0, 62.0, 70.0, 71.0, 75.0, 75.0]",27,13,14,0.5185185185185185,0.48148148148148145
126,2500812,"[5.0, 7.0, 9.0, 16.0, 22.0, 24.0, 26.0, 28.0, 34.0, 34.0, 40.0, 50.0, 53.0, 61.0, 65.0, 68.0, 71.0, 75.0, 78.0, 81.0]",20,9,11,0.55,0.45
127,2500813,"[1.0, 10.0, 21.0, 22.0, 24.0, 32.0, 33.0, 35.0, 38.0, 43.0, 45.0, 42.0, 43.0, 43.0, 53.0, 56.0, 58.0, 59.0, 62.0, 62.0, 64.0, 67.0, 69.0, 71.0, 72.0, 76.0, 76.0, 86.0]",28,15,13,0.4642857142857143,0.5357142857142857
128,2500814,"[2.0, 6.0, 8.0, 11.0, 17.0, 21.0, 22.0, 24.0, 26.0, 29.0, 30.0, 33.0, 37.0, 42.0, 44.0, 40.0, 55.0, 55.0, 57.0, 60.0, 61.0, 62.0, 64.0, 76.0, 80.0, 85.0, 88.0]",27,11,16,0.5925925925925926,0.4074074074074074
129,2500815,"[1.0, 7.0, 9.0, 12.0, 16.0, 21.0, 27.0, 35.0, 38.0, 40.0, 41.0, 44.0, 46.0, 46.0, 51.0, 54.0, 55.0, 57.0, 63.0, 66.0, 67.0, 68.0, 72.0, 73.0, 73.0, 76.0, 86.0, 87.0]",28,16,12,0.42857142857142855,0.5714285714285714
130,2500816,"[0.0, 8.0, 24.0, 26.0, 26.0, 33.0, 41.0, 42.0, 44.0, 45.0, 47.0, 43.0, 44.0, 48.0, 50.0, 55.0, 57.0, 62.0, 63.0, 70.0, 71.0, 72.0, 73.0, 75.0, 76.0, 77.0, 78.0, 82.0]",28,17,11,0.39285714285714285,0.6071428571428571
131,2500817,"[1.0, 3.0, 6.0, 7.0, 12.0, 13.0, 15.0, 18.0, 23.0, 27.0, 28.0, 33.0, 36.0, 38.0, 43.0, 41.0, 42.0, 43.0, 44.0, 48.0, 50.0, 53.0, 58.0, 61.0, 71.0, 73.0, 84.0]",27,8,19,0.7037037037037037,0.2962962962962963
132,2500818,"[2.0, 3.0, 14.0, 15.0, 18.0, 27.0, 29.0, 33.0, 42.0, 43.0, 44.0, 50.0, 51.0, 54.0, 59.0, 60.0, 65.0, 66.0, 67.0, 70.0, 72.0, 76.0, 77.0, 85.0, 88.0]",25,14,11,0.44,0.56
133,2500819,"[2.0, 9.0, 10.0, 16.0, 21.0, 25.0, 26.0, 40.0, 40.0, 44.0, 44.0, 45.0, 46.0, 55.0, 57.0, 66.0, 68.0, 69.0, 75.0, 79.0, 81.0, 83.0, 86.0, 89.0, 90.0]",25,14,11,0.44,0.56
134,2500820,"[8.0, 8.0, 11.0, 12.0, 13.0, 16.0, 24.0, 26.0, 29.0, 34.0, 34.0, 39.0, 44.0, 41.0, 43.0, 45.0, 49.0, 50.0, 51.0, 51.0, 56.0, 58.0, 71.0, 72.0, 73.0, 75.0, 79.0, 82.0, 84.0, 86.0, 89.0]",31,16,15,0.4838709677419355,0.5161290322580645
135,2500821,"[3.0, 10.0, 17.0, 27.0, 28.0, 32.0, 34.0, 38.0, 41.0, 45.0, 46.0, 41.0, 42.0, 43.0, 44.0, 46.0, 49.0, 55.0, 57.0, 59.0, 63.0, 64.0, 66.0, 68.0, 69.0, 72.0, 75.0, 83.0]",28,15,13,0.4642857142857143,0.5357142857142857
136,2500822,"[1.0, 6.0, 7.0, 8.0, 11.0, 13.0, 15.0, 17.0, 17.0, 21.0, 22.0, 24.0, 29.0, 33.0, 34.0, 34.0, 35.0, 40.0, 42.0, 44.0, 42.0, 44.0, 45.0, 49.0, 56.0, 57.0, 61.0, 62.0, 64.0, 68.0, 70.0, 77.0, 81.0, 84.0]",34,12,22,0.6470588235294118,0.35294117647058826
137,2500823,"[1.0, 2.0, 12.0, 12.0, 25.0, 28.0, 31.0, 31.0, 36.0, 37.0, 40.0, 43.0, 43.0, 45.0, 46.0, 49.0, 51.0, 54.0, 56.0, 57.0, 60.0, 61.0, 67.0, 69.0, 70.0, 71.0, 72.0, 76.0, 79.0, 80.0, 89.0]",31,18,13,0.41935483870967744,0.5806451612903226
138,2500824,"[2.0, 8.0, 9.0, 13.0, 19.0, 22.0, 29.0, 31.0, 36.0, 37.0, 43.0, 45.0, 52.0, 54.0, 55.0, 56.0, 59.0, 59.0, 67.0, 70.0, 72.0, 76.0, 79.0, 84.0, 86.0]",25,14,11,0.44,0.56
139,2500825,"[7.0, 9.0, 14.0, 16.0, 17.0, 19.0, 20.0, 28.0, 30.0, 31.0, 34.0, 39.0, 43.0, 45.0, 47.0, 49.0, 56.0, 58.0, 60.0, 65.0, 67.0, 68.0, 72.0, 76.0, 77.0, 78.0, 80.0, 84.0, 84.0, 88.0]",30,17,13,0.43333333333333335,0.5666666666666667
140,2500826,"[1.0, 22.0, 23.0, 27.0, 28.0, 35.0, 43.0, 40.0, 43.0, 47.0, 59.0, 62.0, 65.0, 72.0, 75.0, 77.0, 82.0, 82.0, 83.0, 88.0]",20,11,9,0.45,0.55
141,2500827,"[17.0, 28.0, 29.0, 40.0, 42.0, 44.0, 46.0, 44.0, 47.0, 49.0, 51.0, 55.0, 56.0, 67.0, 70.0, 74.0, 75.0, 77.0, 82.0]",19,12,7,0.3684210526315789,0.631578947368421
142,2500828,"[8.0, 10.0, 12.0, 12.0, 17.0, 24.0, 26.0, 32.0, 33.0, 35.0, 37.0, 41.0, 41.0, 42.0, 43.0, 48.0, 50.0, 53.0, 56.0, 57.0, 59.0, 60.0, 62.0, 65.0, 68.0, 69.0, 70.0, 75.0, 79.0, 80.0, 82.0, 83.0]",32,17,15,0.46875,0.53125
143,2500829,"[0.0, 5.0, 9.0, 12.0, 15.0, 17.0, 19.0, 21.0, 22.0, 29.0, 31.0, 34.0, 35.0, 37.0, 40.0, 41.0, 43.0, 44.0, 47.0, 48.0, 51.0, 55.0, 59.0, 60.0, 61.0, 65.0, 67.0, 73.0, 74.0, 76.0, 77.0, 79.0, 82.0, 83.0, 84.0, 86.0, 87.0, 88.0]",38,20,18,0.47368421052631576,0.5263157894736842
144,2500830,"[3.0, 8.0, 9.0, 22.0, 28.0, 29.0, 34.0, 40.0, 41.0, 44.0, 41.0, 43.0, 47.0, 50.0, 53.0, 60.0, 63.0, 64.0, 75.0, 89.0]",20,8,12,0.6,0.4
145,2500831,"[5.0, 10.0, 10.0, 11.0, 14.0, 21.0, 33.0, 41.0, 41.0, 42.0, 43.0, 43.0, 45.0, 57.0, 68.0, 68.0, 72.0, 73.0, 75.0, 76.0, 80.0]",21,9,12,0.5714285714285714,0.42857142857142855
146,2500832,"[17.0, 21.0, 21.0, 31.0, 34.0, 36.0, 37.0, 38.0, 39.0, 44.0, 44.0, 48.0, 52.0, 52.0, 58.0, 60.0, 67.0, 72.0, 74.0, 79.0, 86.0]",21,10,11,0.5238095238095238,0.47619047619047616
147,2500833,"[2.0, 11.0, 12.0, 22.0, 23.0, 31.0, 32.0, 32.0, 38.0, 43.0, 44.0, 41.0, 45.0, 49.0, 50.0, 50.0, 51.0, 54.0, 58.0, 61.0, 64.0, 69.0, 71.0, 73.0, 78.0, 78.0, 82.0, 84.0, 86.0, 87.0]",30,18,12,0.4,0.6
148,2500834,"[11.0, 13.0, 14.0, 19.0, 24.0, 26.0, 32.0, 33.0, 33.0, 39.0, 40.0, 43.0, 46.0, 47.0, 50.0, 52.0, 61.0, 62.0, 63.0, 64.0, 75.0, 80.0, 81.0, 83.0, 84.0, 85.0]",26,14,12,0.46153846153846156,0.5384615384615384
149,2500835,"[17.0, 21.0, 28.0, 36.0, 37.0, 38.0, 39.0, 44.0, 41.0, 42.0, 45.0, 45.0, 52.0, 56.0, 64.0, 64.0, 70.0, 70.0, 72.0, 74.0, 77.0, 78.0, 79.0, 79.0, 82.0, 84.0, 85.0, 88.0]",28,18,10,0.35714285714285715,0.6428571428571429
150,2500836,"[5.0, 8.0, 10.0, 12.0, 13.0, 14.0, 15.0, 18.0, 19.0, 23.0, 23.0, 30.0, 35.0, 36.0, 40.0, 41.0, 41.0, 44.0, 49.0, 51.0, 53.0, 53.0, 54.0, 54.0, 57.0, 58.0, 59.0, 61.0, 73.0, 76.0, 83.0, 85.0, 85.0, 85.0]",34,16,18,0.5294117647058824,0.47058823529411764
151,2500837,"[1.0, 4.0, 5.0, 6.0, 12.0, 17.0, 29.0, 32.0, 36.0, 37.0, 41.0, 42.0, 45.0, 42.0, 45.0, 45.0, 50.0, 51.0, 53.0, 55.0, 56.0, 58.0, 59.0, 65.0, 66.0, 71.0, 73.0, 76.0, 86.0, 86.0]",30,17,13,0.43333333333333335,0.5666666666666667
152,2500838,"[1.0, 2.0, 12.0, 16.0, 18.0, 19.0, 29.0, 35.0, 38.0, 39.0, 42.0, 44.0, 44.0, 46.0, 40.0, 41.0, 43.0, 45.0, 46.0, 56.0, 63.0, 65.0, 68.0, 70.0, 74.0, 74.0, 75.0, 77.0, 79.0, 79.0, 80.0, 82.0, 83.0, 85.0, 87.0]",35,19,16,0.45714285714285713,0.5428571428571428
153,2500839,"[0.0, 8.0, 12.0, 21.0, 26.0, 27.0, 30.0, 31.0, 32.0, 35.0, 36.0, 37.0, 38.0, 40.0, 41.0, 43.0, 41.0, 43.0, 44.0, 45.0, 47.0, 49.0, 49.0, 51.0, 52.0, 57.0, 61.0, 73.0, 78.0, 81.0, 84.0, 87.0, 88.0, 88.0]",34,15,19,0.5588235294117647,0.4411764705882353
154,2500840,"[1.0, 4.0, 6.0, 8.0, 9.0, 19.0, 20.0, 23.0, 24.0, 27.0, 27.0, 28.0, 31.0, 32.0, 41.0, 42.0, 43.0, 45.0, 45.0, 47.0, 52.0, 55.0, 56.0, 58.0, 70.0, 71.0, 76.0, 77.0, 77.0, 79.0, 81.0, 88.0, 88.0, 89.0]",34,17,17,0.5,0.5
155,2500841,"[3.0, 11.0, 13.0, 16.0, 18.0, 20.0, 23.0, 24.0, 25.0, 27.0, 30.0, 37.0, 40.0, 43.0, 48.0, 49.0, 52.0, 57.0, 59.0, 64.0, 67.0, 68.0, 69.0, 69.0, 71.0, 72.0, 76.0]",27,13,14,0.5185185185185185,0.48148148148148145
156,2500842,"[2.0, 3.0, 6.0, 12.0, 17.0, 19.0, 27.0, 30.0, 37.0, 38.0, 40.0, 44.0, 45.0, 47.0, 51.0, 54.0, 68.0, 71.0, 73.0, 78.0]",20,8,12,0.6,0.4
157,2500843,"[3.0, 3.0, 3.0, 4.0, 5.0, 7.0, 15.0, 18.0, 19.0, 20.0, 24.0, 26.0, 29.0, 35.0, 36.0, 37.0, 44.0, 45.0, 52.0, 53.0, 63.0, 67.0, 69.0, 72.0, 74.0, 76.0, 77.0, 83.0]",28,11,17,0.6071428571428571,0.39285714285714285
158,2500844,"[2.0, 4.0, 8.0, 11.0, 14.0, 20.0, 23.0, 26.0, 35.0, 36.0, 37.0, 43.0, 44.0, 44.0, 49.0, 50.0, 53.0, 55.0, 76.0, 78.0, 80.0, 85.0, 86.0, 87.0, 91.0, 93.0, 93.0]",27,13,14,0.5185185185185185,0.48148148148148145
159,2500845,"[5.0, 15.0, 24.0, 30.0, 33.0, 35.0, 41.0, 41.0, 43.0, 44.0, 44.0, 45.0, 41.0, 50.0, 53.0, 55.0, 56.0, 58.0, 60.0, 66.0, 71.0, 82.0, 86.0, 88.0]",24,12,12,0.5,0.5
160,2500846,"[0.0, 1.0, 2.0, 4.0, 10.0, 12.0, 15.0, 18.0, 27.0, 31.0, 34.0, 35.0, 46.0, 47.0, 50.0, 54.0, 55.0, 56.0, 68.0, 71.0, 73.0, 76.0, 79.0, 81.0, 82.0, 84.0, 87.0]",27,15,12,0.4444444444444444,0.5555555555555556
161,2500847,"[2.0, 3.0, 5.0, 6.0, 7.0, 8.0, 25.0, 26.0, 31.0, 33.0, 39.0, 41.0, 43.0, 48.0, 52.0, 55.0, 58.0, 63.0, 69.0, 73.0, 74.0, 75.0, 78.0, 81.0, 85.0]",25,12,13,0.52,0.48
162,2500848,"[1.0, 3.0, 6.0, 11.0, 15.0, 18.0, 20.0, 26.0, 30.0, 32.0, 35.0, 36.0, 41.0, 45.0, 48.0, 51.0, 53.0, 54.0, 56.0, 60.0, 65.0, 67.0, 72.0, 73.0]",24,11,13,0.5416666666666666,0.4583333333333333
163,2500849,"[5.0, 10.0, 18.0, 23.0, 33.0, 46.0, 48.0, 67.0, 69.0, 71.0, 75.0, 85.0]",12,7,5,0.4166666666666667,0.5833333333333334
164,2500850,"[2.0, 3.0, 8.0, 10.0, 18.0, 18.0, 20.0, 26.0, 28.0, 29.0, 32.0, 38.0, 42.0, 45.0, 45.0, 52.0, 53.0, 55.0, 58.0, 70.0, 72.0, 77.0, 80.0, 83.0]",24,11,13,0.5416666666666666,0.4583333333333333
165,2500851,"[2.0, 3.0, 10.0, 14.0, 19.0, 21.0, 24.0, 25.0, 27.0, 33.0, 38.0, 42.0, 46.0, 48.0, 50.0, 52.0, 53.0, 67.0, 69.0, 71.0, 72.0, 77.0, 80.0, 82.0, 87.0]",25,13,12,0.48,0.52
166,2500852,"[1.0, 4.0, 6.0, 7.0, 8.0, 9.0, 20.0, 24.0, 29.0, 31.0, 34.0, 35.0, 39.0, 39.0, 40.0, 40.0, 41.0, 41.0, 43.0, 45.0, 41.0, 44.0, 46.0, 47.0, 50.0, 54.0, 55.0, 58.0, 59.0, 64.0, 67.0, 67.0, 67.0, 67.0, 69.0, 72.0, 72.0, 82.0, 84.0, 88.0, 89.0]",41,20,21,0.5121951219512195,0.4878048780487805
167,2500853,"[3.0, 15.0, 18.0, 21.0, 23.0, 28.0, 32.0, 37.0, 38.0, 39.0, 41.0, 44.0, 44.0, 41.0, 43.0, 47.0, 54.0, 54.0, 56.0, 57.0, 63.0, 65.0, 73.0, 76.0, 80.0, 81.0]",26,11,15,0.5769230769230769,0.4230769230769231
168,2500854,"[1.0, 10.0, 17.0, 19.0, 20.0, 25.0, 27.0, 31.0, 36.0, 38.0, 44.0, 43.0, 45.0, 46.0, 51.0, 57.0, 58.0, 60.0, 61.0, 62.0, 65.0, 67.0, 67.0, 68.0, 69.0, 70.0, 71.0, 73.0, 74.0, 75.0, 79.0, 80.0, 82.0, 89.0]",34,22,12,0.35294117647058826,0.6470588235294118
169,2500855,"[1.0, 3.0, 4.0, 6.0, 7.0, 12.0, 19.0, 22.0, 23.0, 31.0, 32.0, 45.0, 40.0, 42.0, 61.0, 62.0, 67.0, 71.0, 75.0, 76.0, 80.0, 81.0, 82.0, 85.0, 86.0, 88.0]",26,13,13,0.5,0.5
170,2500856,"[0.0, 1.0, 2.0, 2.0, 3.0, 4.0, 5.0, 6.0, 12.0, 15.0, 17.0, 25.0, 29.0, 35.0, 37.0, 38.0, 41.0, 42.0, 51.0, 53.0, 55.0, 61.0, 62.0, 63.0, 65.0, 66.0, 67.0, 68.0, 69.0, 73.0, 76.0, 80.0, 83.0, 87.0]",34,16,18,0.5294117647058824,0.47058823529411764
171,2500857,"[16.0, 17.0, 20.0, 20.0, 21.0, 23.0, 26.0, 28.0, 37.0, 42.0, 44.0, 41.0, 43.0, 45.0, 50.0, 50.0, 58.0, 59.0, 62.0, 68.0, 74.0, 82.0]",22,9,13,0.5909090909090909,0.4090909090909091
172,2500858,"[5.0, 8.0, 9.0, 12.0, 16.0, 18.0, 19.0, 23.0, 25.0, 26.0, 28.0, 31.0, 38.0, 39.0, 40.0, 43.0, 44.0, 43.0, 50.0, 52.0, 53.0, 56.0, 57.0, 60.0, 63.0, 66.0, 67.0, 69.0, 86.0]",29,11,18,0.6206896551724138,0.3793103448275862
173,2500859,"[3.0, 4.0, 8.0, 11.0, 14.0, 15.0, 19.0, 22.0, 24.0, 33.0, 36.0, 39.0, 42.0, 40.0, 45.0, 46.0, 47.0, 58.0, 60.0, 64.0, 70.0, 70.0, 72.0, 74.0, 76.0, 76.0, 78.0, 80.0, 84.0, 85.0, 86.0]",31,17,14,0.45161290322580644,0.5483870967741935
174,2500860,"[1.0, 1.0, 2.0, 9.0, 12.0, 22.0, 31.0, 33.0, 45.0, 45.0, 40.0, 44.0, 51.0, 54.0, 57.0, 59.0, 63.0, 65.0, 75.0, 76.0, 81.0, 82.0, 83.0, 86.0, 86.0]",25,15,10,0.4,0.6
175,2500861,"[1.0, 1.0, 5.0, 9.0, 10.0, 18.0, 23.0, 25.0, 27.0, 31.0, 37.0, 41.0, 43.0, 41.0, 47.0, 48.0, 61.0, 72.0, 73.0, 74.0, 75.0, 76.0, 77.0, 80.0, 82.0, 86.0]",26,12,14,0.5384615384615384,0.46153846153846156
176,2500862,"[7.0, 7.0, 12.0, 14.0, 24.0, 28.0, 32.0, 42.0, 44.0, 45.0, 46.0, 49.0, 50.0, 53.0, 54.0, 56.0, 57.0, 58.0, 61.0, 67.0, 68.0, 69.0, 72.0, 74.0, 82.0, 83.0, 86.0]",27,18,9,0.3333333333333333,0.6666666666666666
177,2500863,"[1.0, 4.0, 7.0, 9.0, 14.0, 16.0, 19.0, 22.0, 25.0, 25.0, 34.0, 41.0, 42.0, 44.0, 43.0, 48.0, 57.0, 58.0, 62.0, 67.0, 70.0, 81.0, 83.0]",23,8,15,0.6521739130434783,0.34782608695652173
178,2500864,"[0.0, 2.0, 8.0, 12.0, 13.0, 14.0, 18.0, 23.0, 23.0, 28.0, 33.0, 36.0, 38.0, 40.0, 41.0, 42.0, 43.0, 40.0, 41.0, 50.0, 51.0, 53.0, 57.0, 58.0, 61.0, 62.0, 63.0, 67.0, 67.0, 74.0, 76.0, 86.0, 86.0]",33,14,19,0.5757575757575758,0.42424242424242425
179,2500865,"[7.0, 9.0, 11.0, 17.0, 18.0, 22.0, 25.0, 31.0, 43.0, 44.0, 47.0, 48.0, 50.0, 46.0, 47.0, 49.0, 51.0, 52.0, 53.0, 54.0, 56.0, 57.0, 66.0, 67.0, 69.0, 71.0, 71.0, 74.0, 77.0, 77.0, 80.0, 83.0, 86.0, 87.0]",34,24,10,0.29411764705882354,0.7058823529411765
180,2500866,"[3.0, 6.0, 7.0, 13.0, 18.0, 19.0, 22.0, 23.0, 24.0, 25.0, 26.0, 35.0, 37.0, 40.0, 46.0, 44.0, 45.0, 50.0, 59.0, 59.0, 63.0, 64.0, 70.0, 75.0, 78.0, 79.0, 81.0, 81.0, 83.0, 87.0]",30,15,15,0.5,0.5
181,2500867,"[1.0, 5.0, 10.0, 11.0, 16.0, 20.0, 24.0, 25.0, 28.0, 31.0, 31.0, 34.0, 34.0, 36.0, 37.0, 41.0, 45.0, 45.0, 46.0, 45.0, 46.0, 49.0, 51.0, 52.0, 54.0, 55.0, 60.0, 61.0, 65.0, 72.0, 73.0, 75.0, 78.0, 82.0, 84.0, 85.0, 87.0]",37,21,16,0.43243243243243246,0.5675675675675675
182,2500868,"[2.0, 4.0, 6.0, 13.0, 15.0, 16.0, 18.0, 19.0, 25.0, 27.0, 33.0, 34.0, 35.0, 42.0, 45.0, 48.0, 51.0, 53.0, 63.0, 68.0, 74.0, 78.0, 79.0, 80.0, 80.0, 83.0, 88.0, 89.0]",28,14,14,0.5,0.5
183,2500869,"[0.0, 1.0, 2.0, 11.0, 13.0, 14.0, 17.0, 19.0, 20.0, 21.0, 26.0, 28.0, 42.0, 43.0, 44.0, 46.0, 44.0, 47.0, 52.0, 55.0, 63.0, 64.0, 66.0, 79.0, 81.0, 83.0, 90.0]",27,11,16,0.5925925925925926,0.4074074074074074
184,2500870,"[2.0, 5.0, 12.0, 19.0, 26.0, 32.0, 35.0, 40.0, 41.0, 42.0, 43.0, 41.0, 45.0, 48.0, 48.0, 54.0, 55.0, 58.0, 60.0, 61.0, 65.0, 66.0, 73.0, 75.0, 78.0, 80.0, 81.0, 86.0, 86.0, 87.0, 87.0, 88.0]",32,20,12,0.375,0.625
185,2500871,"[2.0, 9.0, 13.0, 27.0, 29.0, 33.0, 45.0, 42.0, 43.0, 44.0, 47.0, 48.0, 49.0, 50.0, 57.0, 60.0, 62.0, 64.0, 65.0, 80.0, 83.0, 85.0, 86.0]",23,14,9,0.391304347826087,0.6086956521739131
186,2500872,"[7.0, 7.0, 9.0, 11.0, 34.0, 37.0, 40.0, 42.0, 43.0, 41.0, 42.0, 46.0, 47.0, 49.0, 54.0, 57.0, 58.0, 59.0, 66.0, 66.0, 68.0, 69.0, 69.0, 71.0, 73.0, 74.0, 79.0, 83.0, 84.0, 89.0]",30,19,11,0.36666666666666664,0.6333333333333333
187,2500873,"[10.0, 14.0, 23.0, 24.0, 25.0, 28.0, 29.0, 33.0, 34.0, 35.0, 36.0, 37.0, 38.0, 40.0, 43.0, 44.0, 46.0, 42.0, 43.0, 47.0, 48.0, 51.0, 52.0, 56.0, 58.0, 60.0, 63.0, 64.0, 64.0, 72.0, 74.0, 78.0, 81.0, 81.0, 82.0, 84.0, 85.0, 86.0, 86.0, 89.0, 89.0]",41,23,18,0.43902439024390244,0.5609756097560976
188,2500874,"[4.0, 6.0, 10.0, 12.0, 18.0, 23.0, 27.0, 35.0, 41.0, 40.0, 49.0, 67.0, 68.0, 71.0, 72.0, 73.0, 74.0, 77.0, 84.0, 87.0]",20,10,10,0.5,0.5
189,2500875,"[0.0, 9.0, 15.0, 17.0, 20.0, 23.0, 26.0, 28.0, 32.0, 33.0, 34.0, 39.0, 41.0, 43.0, 43.0, 43.0, 45.0, 49.0, 56.0, 56.0, 61.0, 66.0, 68.0, 71.0, 72.0, 78.0, 84.0, 89.0]",28,12,16,0.5714285714285714,0.42857142857142855
190,2500876,"[3.0, 14.0, 18.0, 19.0, 28.0, 35.0, 38.0, 39.0, 39.0, 43.0, 44.0, 42.0, 44.0, 48.0, 55.0, 56.0, 60.0, 61.0, 62.0, 63.0, 65.0, 66.0, 69.0, 71.0, 78.0, 81.0, 85.0, 87.0]",28,15,13,0.4642857142857143,0.5357142857142857
191,2500877,"[6.0, 8.0, 9.0, 10.0, 12.0, 17.0, 20.0, 25.0, 28.0, 37.0, 42.0, 46.0, 51.0, 53.0, 54.0, 59.0, 61.0, 61.0, 66.0, 72.0, 73.0, 78.0, 80.0, 84.0, 87.0]",25,14,11,0.44,0.56
192,2500878,"[1.0, 3.0, 9.0, 12.0, 15.0, 20.0, 23.0, 27.0, 30.0, 32.0, 34.0, 36.0, 38.0, 38.0, 40.0, 44.0, 48.0, 48.0, 41.0, 45.0, 48.0, 49.0, 51.0, 57.0, 62.0, 67.0, 71.0, 78.0, 80.0, 84.0, 88.0]",31,14,17,0.5483870967741935,0.45161290322580644
193,2500879,"[4.0, 12.0, 14.0, 15.0, 17.0, 20.0, 26.0, 27.0, 30.0, 31.0, 40.0, 42.0, 44.0, 45.0, 53.0, 56.0, 60.0, 66.0, 77.0, 78.0, 79.0, 80.0, 81.0, 84.0, 86.0, 88.0]",26,13,13,0.5,0.5
194,2500880,"[1.0, 3.0, 9.0, 10.0, 13.0, 14.0, 19.0, 20.0, 21.0, 22.0, 26.0, 27.0, 28.0, 29.0, 31.0, 34.0, 41.0, 42.0, 44.0, 54.0, 58.0, 62.0, 69.0, 76.0, 77.0, 84.0, 85.0, 89.0, 89.0]",29,10,19,0.6551724137931034,0.3448275862068966
195,2500881,"[8.0, 13.0, 17.0, 21.0, 22.0, 25.0, 25.0, 26.0, 27.0, 32.0, 36.0, 39.0, 40.0, 43.0, 50.0, 55.0, 64.0, 69.0, 70.0, 77.0, 81.0, 83.0, 87.0]",23,9,14,0.6086956521739131,0.391304347826087
196,2500882,"[14.0, 16.0, 19.0, 20.0, 22.0, 25.0, 26.0, 33.0, 35.0, 37.0, 40.0, 46.0, 40.0, 45.0, 50.0, 55.0, 57.0, 59.0, 61.0, 66.0, 72.0, 74.0, 80.0, 82.0, 85.0, 87.0]",26,14,12,0.46153846153846156,0.5384615384615384
197,2500883,"[1.0, 2.0, 5.0, 7.0, 9.0, 12.0, 18.0, 24.0, 24.0, 25.0, 29.0, 31.0, 37.0, 41.0, 42.0, 44.0, 46.0, 41.0, 41.0, 43.0, 45.0, 46.0, 51.0, 52.0, 52.0, 55.0, 60.0, 61.0, 63.0, 69.0, 71.0, 75.0, 78.0, 84.0, 85.0, 87.0, 89.0]",37,18,19,0.5135135135135135,0.4864864864864865
198,2500884,"[2.0, 3.0, 4.0, 9.0, 12.0, 12.0, 12.0, 13.0, 15.0, 17.0, 25.0, 34.0, 36.0, 43.0, 44.0, 45.0, 45.0, 51.0, 61.0, 63.0, 65.0, 69.0, 71.0, 71.0, 80.0, 82.0, 84.0, 86.0]",28,13,15,0.5357142857142857,0.4642857142857143
199,2500885,"[0.0, 1.0, 3.0, 11.0, 12.0, 24.0, 25.0, 26.0, 28.0, 32.0, 37.0, 38.0, 38.0, 41.0, 46.0, 43.0, 46.0, 47.0, 50.0, 53.0, 55.0, 57.0, 59.0, 59.0, 63.0, 63.0, 69.0, 80.0, 85.0]",29,14,15,0.5172413793103449,0.4827586206896552
200,2500886,"[1.0, 6.0, 27.0, 29.0, 29.0, 31.0, 37.0, 41.0, 44.0, 46.0, 63.0, 68.0, 73.0, 74.0, 82.0, 86.0, 86.0]",17,8,9,0.5294117647058824,0.47058823529411764
201,2500887,"[3.0, 7.0, 12.0, 20.0, 23.0, 24.0, 26.0, 32.0, 35.0, 36.0, 38.0, 40.0, 43.0, 41.0, 43.0, 44.0, 47.0, 49.0, 55.0, 56.0, 58.0, 59.0, 66.0, 69.0, 73.0, 74.0, 77.0, 78.0, 83.0, 84.0, 85.0, 87.0]",32,16,16,0.5,0.5
202,2500888,"[1.0, 3.0, 6.0, 9.0, 22.0, 23.0, 26.0, 30.0, 45.0, 46.0, 50.0, 55.0, 57.0, 61.0, 63.0, 64.0, 65.0, 71.0, 75.0, 77.0, 79.0, 82.0, 85.0, 87.0, 88.0]",25,17,8,0.32,0.68
203,2500889,"[3.0, 8.0, 10.0, 10.0, 11.0, 15.0, 18.0, 19.0, 20.0, 20.0, 22.0, 23.0, 24.0, 28.0, 29.0, 32.0, 38.0, 40.0, 45.0, 45.0, 41.0, 43.0, 43.0, 44.0, 48.0, 51.0, 54.0, 56.0, 62.0, 63.0, 64.0, 68.0, 73.0, 74.0, 75.0, 77.0, 79.0, 80.0, 87.0]",39,17,22,0.5641025641025641,0.4358974358974359
204,2500890,"[6.0, 8.0, 18.0, 22.0, 31.0, 35.0, 36.0, 36.0, 43.0, 44.0, 41.0, 42.0, 47.0, 68.0, 71.0, 72.0, 77.0, 82.0, 89.0]",19,7,12,0.631578947368421,0.3684210526315789
205,2500891,"[7.0, 10.0, 11.0, 12.0, 13.0, 26.0, 28.0, 29.0, 31.0, 32.0, 38.0, 41.0, 43.0, 45.0, 48.0, 42.0, 56.0, 65.0, 72.0, 78.0, 78.0, 89.0]",22,8,14,0.6363636363636364,0.36363636363636365
206,2500892,"[5.0, 9.0, 12.0, 17.0, 20.0, 20.0, 21.0, 32.0, 36.0, 36.0, 39.0, 41.0, 41.0, 45.0, 50.0, 53.0, 54.0, 58.0, 63.0, 69.0, 69.0, 73.0, 78.0, 79.0, 79.0, 80.0]",26,13,13,0.5,0.5
207,2500893,"[1.0, 17.0, 22.0, 27.0, 29.0, 30.0, 34.0, 34.0, 38.0, 43.0, 46.0, 51.0, 55.0, 55.0, 57.0, 66.0, 69.0, 70.0, 70.0, 72.0, 78.0, 79.0, 81.0, 83.0, 87.0]",25,15,10,0.4,0.6
208,2500894,"[10.0, 10.0, 13.0, 23.0, 25.0, 29.0, 31.0, 35.0, 40.0, 43.0, 44.0, 44.0, 41.0, 41.0, 44.0, 51.0, 57.0, 60.0, 60.0, 61.0, 70.0, 73.0, 77.0, 84.0]",24,9,15,0.625,0.375
209,2500895,"[3.0, 4.0, 9.0, 12.0, 13.0, 20.0, 30.0, 32.0, 36.0, 38.0, 39.0, 39.0, 40.0, 44.0, 41.0, 42.0, 45.0, 47.0, 49.0, 52.0, 54.0, 55.0, 57.0, 58.0, 65.0, 70.0, 71.0, 78.0, 80.0, 83.0, 83.0, 84.0, 89.0]",33,17,16,0.48484848484848486,0.5151515151515151
210,2500896,"[4.0, 5.0, 6.0, 12.0, 14.0, 17.0, 34.0, 43.0, 43.0, 47.0, 48.0, 51.0, 51.0, 56.0, 56.0, 71.0, 73.0, 79.0, 82.0, 83.0, 85.0]",21,12,9,0.42857142857142855,0.5714285714285714
211,2500897,"[5.0, 8.0, 10.0, 11.0, 20.0, 23.0, 26.0, 28.0, 32.0, 36.0, 37.0, 37.0, 41.0, 41.0, 44.0, 46.0, 46.0, 42.0, 43.0, 44.0, 46.0, 47.0, 48.0, 49.0, 52.0, 76.0, 77.0, 80.0, 81.0, 82.0, 83.0, 84.0, 87.0]",33,15,18,0.5454545454545454,0.45454545454545453
212,2500898,"[1.0, 3.0, 7.0, 10.0, 21.0, 25.0, 26.0, 27.0, 28.0, 33.0, 35.0, 38.0, 42.0, 43.0, 44.0, 48.0, 51.0, 51.0, 52.0, 54.0, 58.0, 60.0, 65.0, 67.0, 69.0, 71.0, 74.0, 74.0, 74.0, 84.0]",30,15,15,0.5,0.5
213,2500899,"[5.0, 13.0, 16.0, 17.0, 24.0, 35.0, 37.0, 37.0, 39.0, 40.0, 41.0, 43.0, 43.0, 44.0, 44.0, 50.0, 58.0, 58.0, 59.0, 65.0, 71.0, 74.0, 77.0, 81.0, 86.0, 89.0]",26,11,15,0.5769230769230769,0.4230769230769231
214,2500900,"[4.0, 8.0, 10.0, 12.0, 12.0, 14.0, 16.0, 19.0, 20.0, 24.0, 28.0, 28.0, 31.0, 41.0, 44.0, 45.0, 47.0, 42.0, 47.0, 47.0, 47.0, 53.0, 54.0, 58.0, 64.0, 65.0, 65.0, 66.0, 74.0, 74.0, 78.0, 79.0, 82.0, 86.0, 87.0]",35,19,16,0.45714285714285713,0.5428571428571428
215,2500901,"[1.0, 3.0, 7.0, 11.0, 14.0, 17.0, 28.0, 31.0, 33.0, 35.0, 35.0, 36.0, 38.0, 46.0, 50.0, 53.0, 55.0, 57.0, 58.0, 60.0, 64.0, 70.0, 74.0, 80.0, 82.0, 84.0, 85.0, 86.0, 87.0]",29,16,13,0.4482758620689655,0.5517241379310345
216,2500902,"[3.0, 5.0, 7.0, 8.0, 13.0, 18.0, 19.0, 19.0, 20.0, 23.0, 26.0, 31.0, 35.0, 41.0, 42.0, 44.0, 47.0, 44.0, 45.0, 50.0, 52.0, 53.0, 57.0, 59.0, 62.0, 64.0, 64.0, 65.0, 67.0, 68.0, 69.0, 70.0, 70.0, 72.0, 73.0, 75.0, 77.0, 81.0, 88.0]",39,22,17,0.4358974358974359,0.5641025641025641
217,2500903,"[3.0, 5.0, 5.0, 6.0, 7.0, 23.0, 24.0, 30.0, 31.0, 32.0, 33.0, 35.0, 36.0, 37.0, 38.0, 41.0, 42.0, 41.0, 46.0, 46.0, 48.0, 52.0, 65.0, 69.0, 71.0, 78.0, 80.0, 81.0, 84.0, 85.0, 89.0]",31,13,18,0.5806451612903226,0.41935483870967744
218,2500904,"[1.0, 2.0, 12.0, 15.0, 17.0, 17.0, 21.0, 22.0, 25.0, 26.0, 29.0, 30.0, 30.0, 34.0, 35.0, 42.0, 45.0, 41.0, 45.0, 47.0, 48.0, 50.0, 52.0, 59.0, 62.0, 64.0, 65.0, 66.0, 71.0, 72.0, 75.0, 76.0, 77.0, 78.0, 81.0, 82.0, 85.0, 86.0, 88.0]",39,22,17,0.4358974358974359,0.5641025641025641
219,2500905,"[1.0, 3.0, 10.0, 16.0, 18.0, 21.0, 23.0, 23.0, 28.0, 38.0, 41.0, 43.0, 42.0, 54.0, 55.0, 56.0, 67.0, 68.0, 68.0, 72.0, 73.0, 77.0, 79.0, 85.0]",24,11,13,0.5416666666666666,0.4583333333333333
220,2500906,"[8.0, 11.0, 16.0, 20.0, 20.0, 28.0, 30.0, 36.0, 42.0, 40.0, 45.0, 45.0, 49.0, 51.0, 53.0, 54.0, 56.0, 58.0, 60.0, 61.0, 62.0, 64.0, 67.0, 75.0, 76.0, 79.0, 81.0, 82.0, 82.0, 83.0, 84.0, 87.0]",32,22,10,0.3125,0.6875
221,2500907,"[4.0, 6.0, 11.0, 13.0, 17.0, 23.0, 25.0, 26.0, 29.0, 32.0, 36.0, 37.0, 37.0, 39.0, 46.0, 43.0, 47.0, 55.0, 59.0, 61.0, 61.0, 65.0, 67.0, 70.0, 78.0, 82.0, 84.0, 86.0, 89.0]",29,14,15,0.5172413793103449,0.4827586206896552
222,2500908,"[2.0, 5.0, 9.0, 12.0, 17.0, 18.0, 20.0, 23.0, 26.0, 33.0, 39.0, 40.0, 43.0, 43.0, 45.0, 41.0, 46.0, 47.0, 48.0, 53.0, 54.0, 65.0, 65.0, 77.0, 78.0, 80.0, 84.0, 84.0, 85.0, 88.0]",30,15,15,0.5,0.5
223,2500909,"[3.0, 6.0, 15.0, 16.0, 23.0, 27.0, 29.0, 30.0, 30.0, 34.0, 37.0, 39.0, 43.0, 45.0, 54.0, 54.0, 57.0, 58.0, 61.0, 67.0, 73.0, 80.0, 82.0, 83.0, 84.0, 85.0]",26,13,13,0.5,0.5
224,2500910,"[2.0, 6.0, 10.0, 11.0, 28.0, 40.0, 45.0, 44.0, 46.0, 50.0, 55.0, 56.0, 64.0, 69.0, 76.0, 84.0]",16,9,7,0.4375,0.5625
225,2500911,"[1.0, 10.0, 11.0, 13.0, 13.0, 15.0, 19.0, 22.0, 23.0, 24.0, 30.0, 32.0, 33.0, 35.0, 37.0, 37.0, 47.0, 41.0, 44.0, 50.0, 52.0, 60.0, 62.0, 65.0, 68.0, 69.0, 73.0, 75.0, 76.0, 79.0, 80.0, 82.0, 83.0, 84.0, 87.0]",35,17,18,0.5142857142857142,0.4857142857142857
226,2500912,"[0.0, 1.0, 4.0, 6.0, 9.0, 10.0, 13.0, 14.0, 15.0, 25.0, 28.0, 30.0, 32.0, 32.0, 32.0, 37.0, 41.0, 42.0, 47.0, 42.0, 46.0, 48.0, 51.0, 55.0, 56.0, 58.0, 59.0, 61.0, 62.0, 63.0, 65.0, 67.0, 68.0, 69.0, 70.0, 73.0, 76.0, 78.0, 78.0, 80.0, 81.0, 84.0, 85.0, 85.0, 88.0]",45,26,19,0.4222222222222222,0.5777777777777777
227,2500913,"[2.0, 4.0, 6.0, 7.0, 10.0, 12.0, 13.0, 14.0, 17.0, 21.0, 33.0, 39.0, 42.0, 47.0, 49.0, 51.0, 52.0, 52.0, 54.0, 63.0, 68.0, 69.0, 69.0, 72.0, 73.0, 78.0, 79.0]",27,14,13,0.48148148148148145,0.5185185185185185
228,2500914,"[2.0, 3.0, 4.0, 6.0, 12.0, 18.0, 20.0, 24.0, 26.0, 31.0, 40.0, 42.0, 44.0, 42.0, 46.0, 54.0, 58.0, 59.0, 62.0, 66.0, 68.0, 71.0, 78.0, 79.0, 80.0, 82.0, 84.0, 86.0, 88.0]",29,15,14,0.4827586206896552,0.5172413793103449
229,2500915,"[2.0, 28.0, 30.0, 33.0, 33.0, 38.0, 42.0, 44.0, 45.0, 41.0, 42.0, 44.0, 46.0, 49.0, 54.0, 54.0, 60.0, 64.0, 66.0, 68.0, 76.0, 80.0, 81.0, 82.0, 86.0, 87.0]",26,15,11,0.4230769230769231,0.5769230769230769
230,2500916,"[4.0, 17.0, 18.0, 20.0, 21.0, 23.0, 25.0, 27.0, 28.0, 36.0, 39.0, 40.0, 41.0, 42.0, 43.0, 48.0, 50.0, 50.0, 51.0, 53.0, 54.0, 59.0, 65.0, 72.0, 77.0]",25,10,15,0.6,0.4
231,2500917,"[10.0, 11.0, 14.0, 21.0, 23.0, 28.0, 33.0, 33.0, 39.0, 42.0, 45.0, 64.0, 65.0, 68.0, 68.0, 71.0, 77.0, 80.0, 82.0, 84.0, 87.0]",21,11,10,0.47619047619047616,0.5238095238095238
232,2500918,"[1.0, 4.0, 11.0, 20.0, 27.0, 39.0, 40.0, 42.0, 51.0, 58.0, 64.0, 68.0, 70.0, 76.0, 87.0]",15,7,8,0.5333333333333333,0.4666666666666667
233,2500919,"[4.0, 12.0, 13.0, 15.0, 21.0, 27.0, 30.0, 31.0, 33.0, 35.0, 36.0, 38.0, 41.0, 43.0, 41.0, 42.0, 44.0, 46.0, 49.0, 67.0, 74.0, 75.0, 76.0, 76.0, 81.0, 86.0]",26,9,17,0.6538461538461539,0.34615384615384615
234,2500920,"[0.0, 3.0, 4.0, 8.0, 9.0, 16.0, 18.0, 19.0, 20.0, 21.0, 22.0, 29.0, 30.0, 34.0, 35.0, 38.0, 39.0, 41.0, 43.0, 44.0, 41.0, 42.0, 42.0, 43.0, 57.0, 64.0, 71.0, 78.0, 80.0, 82.0, 84.0, 86.0, 87.0]",33,9,24,0.7272727272727273,0.2727272727272727
235,2500921,"[3.0, 9.0, 11.0, 18.0, 19.0, 32.0, 33.0, 38.0, 42.0, 53.0, 58.0, 61.0, 67.0, 68.0, 69.0, 72.0, 76.0, 85.0, 87.0, 87.0]",20,11,9,0.45,0.55
236,2500922,"[11.0, 13.0, 14.0, 16.0, 17.0, 18.0, 20.0, 43.0, 44.0, 44.0, 47.0, 52.0, 53.0, 55.0, 63.0, 64.0, 66.0, 67.0, 73.0, 74.0, 74.0, 77.0, 78.0, 79.0, 79.0, 80.0, 80.0, 82.0, 87.0]",29,19,10,0.3448275862068966,0.6551724137931034
237,2500923,"[3.0, 6.0, 9.0, 12.0, 15.0, 22.0, 23.0, 24.0, 27.0, 30.0, 31.0, 32.0, 37.0, 41.0, 42.0, 47.0, 52.0, 52.0, 53.0, 58.0, 59.0, 61.0, 63.0, 64.0, 66.0, 66.0, 68.0, 71.0, 74.0, 75.0, 78.0, 79.0, 84.0]",33,18,15,0.45454545454545453,0.5454545454545454
238,2500924,"[1.0, 4.0, 8.0, 17.0, 20.0, 25.0, 25.0, 29.0, 30.0, 41.0, 44.0, 42.0, 46.0, 51.0, 51.0, 56.0, 60.0, 67.0, 73.0, 73.0, 74.0, 76.0, 77.0, 79.0, 80.0, 80.0, 81.0, 85.0, 86.0, 86.0]",30,18,12,0.4,0.6
239,2500925,"[4.0, 5.0, 7.0, 10.0, 17.0, 21.0, 24.0, 27.0, 28.0, 31.0, 32.0, 36.0, 40.0, 41.0, 45.0, 47.0, 49.0, 55.0, 56.0, 57.0, 70.0, 71.0, 72.0, 75.0, 77.0, 78.0, 78.0, 84.0]",28,14,14,0.5,0.5
240,2500926,"[13.0, 15.0, 18.0, 21.0, 26.0, 31.0, 41.0, 45.0, 41.0, 43.0, 49.0, 54.0, 63.0, 70.0, 83.0, 84.0, 85.0]",17,8,9,0.5294117647058824,0.47058823529411764
241,2500927,"[7.0, 12.0, 17.0, 22.0, 22.0, 24.0, 30.0, 34.0, 36.0, 44.0, 43.0, 43.0, 45.0, 48.0, 54.0, 59.0, 62.0, 64.0, 70.0, 82.0, 83.0, 87.0, 88.0, 91.0]",24,12,12,0.5,0.5
242,2500928,"[0.0, 2.0, 10.0, 14.0, 19.0, 25.0, 29.0, 32.0, 36.0, 39.0, 40.0, 42.0, 43.0, 44.0, 46.0, 41.0, 43.0, 43.0, 46.0, 51.0, 66.0, 68.0, 71.0, 75.0, 75.0, 77.0, 80.0, 83.0, 85.0, 87.0]",30,13,17,0.5666666666666667,0.43333333333333335
243,2500929,"[6.0, 10.0, 20.0, 21.0, 25.0, 30.0, 32.0, 33.0, 37.0, 38.0, 42.0, 42.0, 43.0, 45.0, 45.0, 46.0, 45.0, 51.0, 57.0, 57.0, 58.0, 61.0, 61.0, 65.0, 67.0, 68.0, 71.0, 76.0, 80.0, 81.0]",30,17,13,0.43333333333333335,0.5666666666666667
244,2500930,"[3.0, 6.0, 8.0, 12.0, 18.0, 21.0, 26.0, 29.0, 29.0, 39.0, 43.0, 42.0, 46.0, 46.0, 53.0, 53.0, 56.0, 56.0, 57.0, 59.0, 61.0, 65.0, 68.0, 75.0, 76.0, 77.0, 83.0]",27,15,12,0.4444444444444444,0.5555555555555556
245,2500931,"[2.0, 8.0, 9.0, 9.0, 9.0, 12.0, 16.0, 25.0, 31.0, 35.0, 36.0, 37.0, 43.0, 48.0, 48.0, 52.0, 54.0, 55.0, 62.0, 65.0, 69.0, 71.0, 73.0, 75.0, 77.0, 88.0]",26,13,13,0.5,0.5
246,2500932,"[1.0, 4.0, 7.0, 8.0, 12.0, 17.0, 20.0, 29.0, 33.0, 34.0, 37.0, 42.0, 43.0, 45.0, 47.0, 51.0, 57.0, 70.0, 73.0, 77.0]",20,7,13,0.65,0.35
247,2500933,"[10.0, 13.0, 17.0, 27.0, 30.0, 31.0, 36.0, 44.0, 46.0, 42.0, 44.0, 49.0, 50.0, 52.0, 54.0, 55.0, 65.0, 68.0, 69.0, 72.0, 76.0, 80.0, 85.0, 86.0]",24,14,10,0.4166666666666667,0.5833333333333334
248,2500934,"[3.0, 4.0, 6.0, 6.0, 11.0, 13.0, 24.0, 25.0, 33.0, 34.0, 36.0, 44.0, 41.0, 42.0, 46.0, 73.0, 75.0, 79.0, 83.0, 84.0, 85.0]",21,7,14,0.6666666666666666,0.3333333333333333
249,2500935,"[1.0, 5.0, 13.0, 15.0, 18.0, 20.0, 21.0, 21.0, 23.0, 24.0, 25.0, 30.0, 35.0, 38.0, 40.0, 43.0, 45.0, 45.0, 49.0, 50.0, 51.0, 54.0, 56.0, 64.0, 66.0, 69.0, 71.0, 75.0, 79.0, 80.0, 80.0, 83.0, 85.0]",33,17,16,0.48484848484848486,0.5151515151515151
250,2500936,"[14.0, 24.0, 26.0, 27.0, 30.0, 37.0, 43.0, 45.0, 43.0, 44.0, 45.0, 49.0, 52.0, 57.0, 57.0, 60.0, 64.0, 69.0, 70.0, 79.0, 82.0, 83.0, 84.0, 85.0, 87.0, 88.0]",26,17,9,0.34615384615384615,0.6538461538461539
251,2500937,"[10.0, 11.0, 12.0, 13.0, 20.0, 20.0, 26.0, 28.0, 33.0, 38.0, 41.0, 50.0, 51.0, 53.0, 61.0, 64.0, 67.0, 69.0, 72.0, 73.0, 75.0, 81.0, 85.0, 86.0, 86.0, 88.0, 88.0, 89.0]",28,17,11,0.39285714285714285,0.6071428571428571
252,2500938,"[18.0, 24.0, 34.0, 39.0, 42.0, 42.0, 51.0, 52.0, 62.0, 70.0, 75.0, 82.0, 83.0]",13,7,6,0.46153846153846156,0.5384615384615384
253,2500939,"[5.0, 6.0, 11.0, 14.0, 16.0, 23.0, 25.0, 27.0, 30.0, 31.0, 38.0, 46.0, 40.0, 41.0, 51.0, 55.0, 58.0, 58.0, 61.0, 74.0, 78.0, 81.0, 83.0, 85.0]",24,11,13,0.5416666666666666,0.4583333333333333
254,2500940,"[2.0, 9.0, 15.0, 20.0, 24.0, 37.0, 40.0, 42.0, 43.0, 44.0, 45.0, 48.0, 55.0, 56.0, 62.0, 67.0, 72.0, 72.0, 75.0, 78.0, 81.0, 84.0, 88.0]",23,13,10,0.43478260869565216,0.5652173913043478
255,2500941,"[3.0, 10.0, 11.0, 17.0, 21.0, 31.0, 36.0, 38.0, 43.0, 45.0, 46.0, 50.0, 51.0, 51.0, 52.0, 53.0, 58.0, 61.0, 62.0, 67.0, 73.0, 74.0, 77.0, 77.0, 87.0]",25,16,9,0.36,0.64
256,2500942,"[10.0, 11.0, 16.0, 18.0, 21.0, 28.0, 31.0, 33.0, 36.0, 38.0, 39.0, 40.0, 52.0, 55.0, 62.0, 63.0, 66.0, 71.0, 73.0, 80.0, 83.0, 84.0, 86.0]",23,11,12,0.5217391304347826,0.4782608695652174
257,2500943,"[1.0, 2.0, 4.0, 8.0, 10.0, 10.0, 21.0, 25.0, 29.0, 32.0, 43.0, 45.0, 50.0, 50.0, 53.0, 56.0, 58.0, 60.0, 67.0, 71.0, 72.0, 80.0]",22,11,11,0.5,0.5
258,2500944,"[2.0, 5.0, 11.0, 15.0, 16.0, 23.0, 26.0, 26.0, 29.0, 37.0, 38.0, 38.0, 44.0, 41.0, 43.0, 45.0, 52.0, 53.0, 59.0, 63.0, 64.0, 68.0, 69.0, 79.0, 82.0, 84.0]",26,11,15,0.5769230769230769,0.4230769230769231
259,2500945,"[2.0, 5.0, 13.0, 16.0, 18.0, 22.0, 32.0, 37.0, 46.0, 52.0, 53.0, 58.0, 64.0, 65.0, 76.0, 78.0, 86.0, 88.0, 88.0]",19,11,8,0.42105263157894735,0.5789473684210527
260,2500946,"[1.0, 1.0, 20.0, 25.0, 28.0, 30.0, 32.0, 32.0, 34.0, 37.0, 41.0, 45.0, 43.0, 44.0, 45.0, 47.0, 48.0, 49.0, 52.0, 54.0, 55.0, 57.0, 58.0, 59.0, 62.0, 66.0, 68.0, 72.0, 73.0, 77.0, 80.0, 81.0, 81.0, 82.0, 85.0]",35,22,13,0.37142857142857144,0.6285714285714286
261,2500947,"[1.0, 1.0, 3.0, 10.0, 10.0, 13.0, 14.0, 16.0, 28.0, 31.0, 33.0, 33.0, 37.0, 44.0, 43.0, 54.0, 59.0, 63.0, 64.0, 70.0, 78.0, 82.0, 83.0, 85.0]",24,9,15,0.625,0.375
262,2500948,"[5.0, 5.0, 8.0, 9.0, 15.0, 18.0, 20.0, 20.0, 30.0, 31.0, 33.0, 36.0, 37.0, 43.0, 44.0, 42.0, 47.0, 48.0, 55.0, 57.0, 58.0, 60.0, 63.0, 69.0, 70.0, 70.0, 72.0, 74.0, 78.0, 85.0, 86.0, 88.0]",32,16,16,0.5,0.5
263,2500949,"[0.0, 9.0, 15.0, 17.0, 19.0, 21.0, 31.0, 31.0, 39.0, 45.0, 50.0, 51.0, 55.0, 56.0, 58.0, 58.0, 63.0, 73.0, 75.0, 77.0, 83.0, 86.0, 87.0]",23,14,9,0.391304347826087,0.6086956521739131
264,2500950,"[1.0, 3.0, 6.0, 18.0, 21.0, 27.0, 28.0, 30.0, 32.0, 34.0, 38.0, 42.0, 42.0, 45.0, 46.0, 42.0, 43.0, 51.0, 52.0, 53.0, 56.0, 60.0, 61.0, 63.0, 71.0, 71.0, 72.0, 73.0, 77.0, 78.0, 83.0, 87.0, 87.0]",33,18,15,0.45454545454545453,0.5454545454545454
265,2500951,"[8.0, 8.0, 10.0, 13.0, 13.0, 17.0, 19.0, 32.0, 38.0, 41.0, 43.0, 45.0, 45.0, 42.0, 45.0, 49.0, 52.0, 55.0, 61.0, 62.0, 63.0, 67.0, 70.0, 73.0, 78.0, 83.0, 85.0, 86.0]",28,16,12,0.42857142857142855,0.5714285714285714
266,2500952,"[1.0, 3.0, 4.0, 8.0, 12.0, 14.0, 17.0, 21.0, 28.0, 28.0, 29.0, 30.0, 31.0, 32.0, 32.0, 33.0, 38.0, 38.0, 43.0, 43.0, 44.0, 46.0, 43.0, 43.0, 46.0, 51.0, 52.0, 54.0, 54.0, 54.0, 57.0, 60.0, 67.0, 70.0, 70.0, 76.0, 77.0, 78.0, 78.0, 79.0, 81.0, 84.0]",42,19,23,0.5476190476190477,0.4523809523809524
267,2500953,"[2.0, 14.0, 32.0, 35.0, 43.0, 40.0, 50.0, 51.0, 54.0, 55.0, 61.0, 62.0, 72.0, 73.0, 75.0, 77.0, 79.0, 80.0, 87.0, 88.0]",20,14,6,0.3,0.7
268,2500954,"[1.0, 4.0, 5.0, 7.0, 9.0, 11.0, 13.0, 14.0, 17.0, 20.0, 26.0, 30.0, 34.0, 34.0, 36.0, 38.0, 39.0, 40.0, 41.0, 42.0, 44.0, 45.0, 54.0, 58.0, 61.0, 67.0, 75.0, 78.0, 82.0, 85.0, 88.0]",31,10,21,0.6774193548387096,0.3225806451612903
269,2500955,"[0.0, 6.0, 7.0, 9.0, 14.0, 15.0, 16.0, 23.0, 28.0, 34.0, 35.0, 46.0, 48.0, 50.0, 52.0, 53.0, 53.0, 54.0, 60.0, 69.0, 70.0, 74.0, 78.0, 80.0, 83.0, 85.0, 87.0, 87.0, 87.0]",29,18,11,0.3793103448275862,0.6206896551724138
270,2500956,"[1.0, 4.0, 7.0, 8.0, 10.0, 13.0, 13.0, 16.0, 21.0, 22.0, 25.0, 26.0, 26.0, 27.0, 27.0, 31.0, 35.0, 38.0, 38.0, 42.0, 42.0, 41.0, 44.0, 47.0, 50.0, 64.0, 68.0, 72.0, 74.0, 82.0, 84.0, 84.0, 85.0, 87.0, 87.0, 88.0]",36,13,23,0.6388888888888888,0.3611111111111111
271,2500957,"[2.0, 5.0, 25.0, 27.0, 27.0, 31.0, 33.0, 35.0, 38.0, 44.0, 46.0, 53.0, 55.0, 58.0, 60.0, 61.0, 63.0, 69.0, 71.0, 77.0, 80.0, 87.0]",22,12,10,0.45454545454545453,0.5454545454545454
272,2500958,"[2.0, 4.0, 13.0, 14.0, 31.0, 32.0, 34.0, 36.0, 41.0, 41.0, 43.0, 44.0, 46.0, 49.0, 50.0, 52.0, 59.0, 62.0, 63.0, 68.0, 69.0, 74.0, 77.0, 77.0, 78.0, 79.0, 80.0, 86.0]",28,16,12,0.42857142857142855,0.5714285714285714
273,2500959,"[0.0, 3.0, 8.0, 9.0, 14.0, 18.0, 20.0, 22.0, 24.0, 31.0, 34.0, 39.0, 39.0, 43.0, 41.0, 41.0, 45.0, 49.0, 55.0, 61.0, 64.0, 67.0, 73.0, 79.0, 82.0, 83.0, 84.0, 90.0]",28,12,16,0.5714285714285714,0.42857142857142855
274,2500960,"[1.0, 3.0, 6.0, 10.0, 12.0, 14.0, 17.0, 21.0, 23.0, 29.0, 36.0, 42.0, 44.0, 50.0, 60.0, 64.0, 69.0, 71.0, 80.0, 82.0, 86.0]",21,8,13,0.6190476190476191,0.38095238095238093
275,2500961,"[1.0, 13.0, 17.0, 17.0, 19.0, 22.0, 24.0, 25.0, 35.0, 40.0, 42.0, 44.0, 52.0, 54.0, 57.0, 65.0, 68.0, 71.0, 79.0, 83.0, 84.0, 87.0]",22,10,12,0.5454545454545454,0.45454545454545453
276,2500962,"[5.0, 12.0, 12.0, 16.0, 19.0, 20.0, 22.0, 27.0, 30.0, 39.0, 44.0, 44.0, 46.0, 48.0, 50.0, 54.0, 59.0, 59.0, 71.0, 83.0, 87.0]",21,9,12,0.5714285714285714,0.42857142857142855
277,2500963,"[1.0, 2.0, 6.0, 16.0, 20.0, 24.0, 28.0, 34.0, 42.0, 43.0, 44.0, 46.0, 42.0, 47.0, 51.0, 57.0, 68.0, 80.0, 82.0, 82.0, 85.0]",21,9,12,0.5714285714285714,0.42857142857142855
278,2500964,"[4.0, 5.0, 11.0, 19.0, 34.0, 36.0, 37.0, 37.0, 38.0, 43.0, 48.0, 42.0, 43.0, 46.0, 47.0, 58.0, 66.0, 67.0, 68.0, 70.0, 80.0, 82.0, 82.0, 83.0, 86.0]",25,13,12,0.48,0.52
279,2500965,"[5.0, 15.0, 28.0, 35.0, 38.0, 41.0, 43.0, 49.0, 61.0, 61.0, 69.0, 72.0, 80.0, 84.0]",14,7,7,0.5,0.5
280,2500966,"[1.0, 7.0, 17.0, 24.0, 27.0, 31.0, 33.0, 37.0, 42.0, 45.0, 55.0, 56.0, 63.0, 73.0, 80.0, 81.0]",16,7,9,0.5625,0.4375
281,2500967,"[2.0, 7.0, 12.0, 22.0, 23.0, 28.0, 31.0, 43.0, 45.0, 41.0, 44.0, 53.0, 53.0, 55.0, 56.0, 59.0, 61.0, 67.0, 67.0, 75.0, 77.0, 79.0, 79.0, 82.0, 85.0]",25,15,10,0.4,0.6
282,2500968,"[0.0, 2.0, 3.0, 4.0, 4.0, 7.0, 10.0, 11.0, 13.0, 16.0, 18.0, 21.0, 26.0, 27.0, 32.0, 37.0, 38.0, 39.0, 40.0, 43.0, 43.0, 44.0, 54.0, 55.0, 56.0, 59.0, 65.0, 69.0, 77.0, 79.0, 80.0, 83.0]",32,10,22,0.6875,0.3125
283,2500969,"[2.0, 10.0, 14.0, 17.0, 19.0, 20.0, 21.0, 28.0, 30.0, 31.0, 33.0, 36.0, 46.0, 46.0, 41.0, 42.0, 48.0, 49.0, 50.0, 50.0, 53.0, 53.0, 57.0, 65.0, 68.0, 69.0, 71.0, 74.0, 81.0, 82.0, 82.0, 88.0]",32,18,14,0.4375,0.5625
284,2500970,"[2.0, 4.0, 14.0, 18.0, 24.0, 28.0, 41.0, 41.0, 49.0, 75.0, 80.0]",11,3,8,0.7272727272727273,0.2727272727272727
285,2500971,"[1.0, 6.0, 14.0, 22.0, 23.0, 26.0, 45.0, 43.0, 45.0, 54.0, 58.0, 80.0]",12,5,7,0.5833333333333334,0.4166666666666667
286,2500972,"[4.0, 9.0, 13.0, 16.0, 18.0, 30.0, 32.0, 39.0, 41.0, 43.0, 43.0, 45.0, 49.0, 55.0, 62.0, 63.0, 63.0, 65.0, 72.0, 75.0]",20,9,11,0.55,0.45
287,2500973,"[9.0, 9.0, 17.0, 18.0, 19.0, 20.0, 21.0, 26.0, 29.0, 31.0, 32.0, 34.0, 45.0, 47.0, 50.0, 55.0, 55.0, 56.0, 59.0, 60.0, 61.0, 69.0, 70.0, 70.0, 70.0, 71.0, 75.0, 82.0, 83.0, 85.0]",30,18,12,0.4,0.6
288,2500974,"[10.0, 25.0, 26.0, 27.0, 32.0, 34.0, 37.0, 37.0, 38.0, 42.0, 47.0, 40.0, 47.0, 49.0, 51.0, 53.0, 60.0, 60.0, 61.0, 62.0, 64.0, 66.0, 69.0, 73.0, 74.0, 80.0, 90.0]",27,16,11,0.4074074074074074,0.5925925925925926
289,2500975,"[7.0, 9.0, 12.0, 12.0, 22.0, 27.0, 29.0, 32.0, 32.0, 34.0, 37.0, 38.0, 40.0, 41.0, 43.0, 46.0, 44.0, 44.0, 51.0, 52.0, 57.0, 59.0, 63.0, 63.0, 64.0, 71.0, 75.0, 80.0, 83.0, 84.0, 84.0, 86.0, 88.0, 88.0, 90.0, 90.0]",36,19,17,0.4722222222222222,0.5277777777777778
290,2500976,"[0.0, 3.0, 6.0, 7.0, 11.0, 12.0, 12.0, 18.0, 28.0, 30.0, 32.0, 36.0, 38.0, 40.0, 43.0, 41.0, 48.0, 50.0, 52.0, 55.0, 57.0, 65.0, 66.0, 73.0, 85.0]",25,9,16,0.64,0.36
291,2500977,"[7.0, 11.0, 11.0, 12.0, 13.0, 17.0, 20.0, 24.0, 26.0, 34.0, 39.0, 41.0, 42.0, 49.0, 59.0, 60.0, 64.0, 71.0, 72.0, 76.0, 76.0, 80.0]",22,9,13,0.5909090909090909,0.4090909090909091
292,2500978,"[9.0, 15.0, 29.0, 30.0, 33.0, 37.0, 39.0, 40.0, 44.0, 45.0, 45.0, 55.0, 63.0, 65.0, 66.0, 77.0, 77.0, 82.0, 83.0, 84.0, 86.0]",21,12,9,0.42857142857142855,0.5714285714285714
293,2500979,"[0.0, 3.0, 17.0, 18.0, 21.0, 25.0, 30.0, 39.0, 40.0, 41.0, 46.0, 41.0, 42.0, 43.0, 44.0, 58.0, 70.0, 72.0, 72.0, 75.0, 77.0, 77.0, 80.0, 81.0, 84.0, 86.0, 87.0, 89.0]",28,14,14,0.5,0.5
294,2500980,"[13.0, 14.0, 26.0, 28.0, 39.0, 44.0, 44.0, 49.0, 50.0, 55.0, 57.0, 65.0, 71.0, 75.0, 78.0, 81.0, 87.0, 87.0, 89.0]",19,12,7,0.3684210526315789,0.631578947368421
295,2500981,"[3.0, 8.0, 14.0, 23.0, 27.0, 28.0, 29.0, 30.0, 30.0, 35.0, 37.0, 41.0, 48.0, 48.0, 62.0, 64.0, 69.0, 73.0, 80.0, 81.0, 81.0, 85.0, 86.0, 87.0, 88.0]",25,13,12,0.48,0.52
296,2500982,"[0.0, 3.0, 21.0, 23.0, 24.0, 27.0, 30.0, 37.0, 42.0, 44.0, 46.0, 45.0, 46.0, 47.0, 49.0, 52.0, 56.0, 66.0, 67.0, 68.0, 69.0, 71.0, 72.0, 78.0, 80.0, 82.0, 83.0, 83.0, 85.0, 88.0]",30,20,10,0.3333333333333333,0.6666666666666666
297,2500983,"[4.0, 7.0, 11.0, 22.0, 25.0, 30.0, 31.0, 34.0, 47.0, 43.0, 46.0, 46.0, 47.0, 54.0, 56.0, 64.0, 66.0, 69.0, 74.0, 84.0, 87.0]",21,12,9,0.42857142857142855,0.5714285714285714
298,2500984,"[0.0, 3.0, 12.0, 20.0, 21.0, 25.0, 30.0, 32.0, 34.0, 38.0, 42.0, 42.0, 46.0, 41.0, 44.0, 44.0, 45.0, 46.0, 49.0, 50.0, 53.0, 54.0, 59.0, 66.0, 69.0, 70.0, 74.0, 82.0]",28,13,15,0.5357142857142857,0.4642857142857143
299,2500985,"[0.0, 4.0, 5.0, 9.0, 12.0, 13.0, 14.0, 16.0, 18.0, 22.0, 26.0, 29.0, 30.0, 36.0, 42.0, 43.0, 52.0, 57.0, 60.0, 67.0, 78.0, 80.0, 81.0, 81.0]",24,8,16,0.6666666666666666,0.3333333333333333
300,2500986,"[1.0, 4.0, 7.0, 10.0, 11.0, 14.0, 15.0, 16.0, 20.0, 24.0, 25.0, 27.0, 27.0, 28.0, 28.0, 29.0, 32.0, 38.0, 40.0, 47.0, 41.0, 44.0, 44.0, 51.0, 52.0, 66.0, 68.0, 71.0, 83.0, 86.0, 87.0, 87.0]",32,10,22,0.6875,0.3125
301,2500987,"[1.0, 4.0, 5.0, 9.0, 11.0, 12.0, 12.0, 15.0, 19.0, 22.0, 32.0, 37.0, 39.0, 46.0, 50.0, 51.0, 53.0, 57.0, 58.0, 60.0, 62.0, 71.0, 79.0, 84.0, 86.0, 87.0, 89.0]",27,14,13,0.48148148148148145,0.5185185185185185
302,2500988,"[6.0, 7.0, 11.0, 13.0, 15.0, 18.0, 25.0, 28.0, 29.0, 34.0, 39.0, 42.0, 41.0, 42.0, 44.0, 49.0, 52.0, 56.0, 65.0, 74.0, 79.0, 79.0, 80.0, 84.0, 86.0, 87.0]",26,11,15,0.5769230769230769,0.4230769230769231
303,2500989,"[4.0, 8.0, 14.0, 18.0, 21.0, 26.0, 26.0, 33.0, 34.0, 36.0, 38.0, 39.0, 44.0, 44.0, 54.0, 56.0, 61.0, 61.0, 68.0, 71.0, 71.0, 83.0, 84.0, 87.0]",24,10,14,0.5833333333333334,0.4166666666666667
304,2500990,"[0.0, 3.0, 4.0, 15.0, 16.0, 19.0, 20.0, 25.0, 32.0, 39.0, 41.0, 45.0, 46.0, 42.0, 47.0, 49.0, 53.0, 57.0, 63.0, 66.0, 72.0, 74.0, 82.0, 83.0]",24,12,12,0.5,0.5
305,2500991,"[0.0, 3.0, 9.0, 11.0, 19.0, 22.0, 24.0, 27.0, 29.0, 32.0, 37.0, 38.0, 40.0, 43.0, 45.0, 43.0, 44.0, 44.0, 48.0, 50.0, 51.0, 55.0, 60.0, 61.0, 65.0, 72.0, 84.0]",27,10,17,0.6296296296296297,0.37037037037037035
306,2500992,"[4.0, 14.0, 20.0, 32.0, 32.0, 39.0, 40.0, 43.0, 44.0, 52.0, 54.0, 68.0, 72.0, 73.0, 74.0, 80.0, 81.0, 84.0]",18,9,9,0.5,0.5
307,2500993,"[2.0, 6.0, 7.0, 8.0, 10.0, 14.0, 15.0, 22.0, 24.0, 32.0, 33.0, 36.0, 37.0, 38.0, 44.0, 41.0, 42.0, 43.0, 52.0, 53.0, 54.0, 58.0, 59.0, 63.0, 63.0, 65.0, 67.0, 69.0, 69.0, 77.0, 78.0, 80.0, 81.0, 82.0, 84.0, 84.0, 86.0, 88.0]",38,20,18,0.47368421052631576,0.5263157894736842
308,2500994,"[2.0, 4.0, 7.0, 7.0, 11.0, 11.0, 13.0, 16.0, 19.0, 20.0, 24.0, 26.0, 27.0, 33.0, 34.0, 36.0, 37.0, 38.0, 40.0, 44.0, 46.0, 50.0, 51.0, 51.0, 56.0, 56.0, 57.0, 60.0, 61.0, 63.0, 64.0, 64.0, 68.0, 70.0, 71.0, 71.0, 77.0, 77.0, 79.0, 82.0, 84.0, 87.0, 88.0]",43,23,20,0.46511627906976744,0.5348837209302325
309,2500995,"[2.0, 3.0, 18.0, 24.0, 28.0, 32.0, 35.0, 38.0, 40.0, 45.0, 43.0, 49.0, 57.0, 60.0, 69.0, 75.0, 77.0, 79.0, 80.0, 81.0, 83.0]",21,11,10,0.47619047619047616,0.5238095238095238
310,2500996,"[11.0, 13.0, 14.0, 18.0, 22.0, 26.0, 27.0, 32.0, 33.0, 35.0, 40.0, 41.0, 50.0, 56.0, 57.0, 61.0, 62.0, 64.0, 66.0, 66.0, 71.0, 73.0, 77.0, 78.0, 78.0, 79.0, 80.0, 87.0]",28,16,12,0.42857142857142855,0.5714285714285714
311,2500997,"[2.0, 8.0, 12.0, 16.0, 18.0, 19.0, 20.0, 25.0, 30.0, 31.0, 33.0, 34.0, 39.0, 45.0, 46.0, 44.0, 52.0, 55.0, 59.0, 62.0, 63.0, 64.0, 71.0, 74.0, 77.0, 83.0, 86.0]",27,13,14,0.5185185185185185,0.48148148148148145
312,2500998,"[4.0, 6.0, 8.0, 20.0, 23.0, 25.0, 28.0, 30.0, 31.0, 33.0, 43.0, 47.0, 50.0, 54.0, 54.0, 55.0, 57.0, 60.0, 65.0, 66.0, 70.0, 83.0, 84.0, 85.0, 85.0, 87.0]",26,15,11,0.4230769230769231,0.5769230769230769
313,2500999,"[3.0, 14.0, 20.0, 20.0, 24.0, 24.0, 26.0, 30.0, 31.0, 36.0, 41.0, 43.0, 43.0, 44.0, 45.0, 43.0, 47.0, 56.0, 59.0, 61.0, 66.0, 70.0]",22,7,15,0.6818181818181818,0.3181818181818182
314,2501000,"[3.0, 4.0, 8.0, 20.0, 30.0, 32.0, 36.0, 37.0, 40.0, 43.0, 44.0, 46.0, 48.0, 51.0, 62.0, 64.0, 69.0, 70.0, 72.0, 73.0, 79.0, 81.0, 82.0, 82.0, 82.0, 87.0]",26,15,11,0.4230769230769231,0.5769230769230769
315,2501001,"[4.0, 10.0, 11.0, 11.0, 14.0, 16.0, 27.0, 28.0, 31.0, 32.0, 33.0, 35.0, 38.0, 44.0, 40.0, 41.0, 43.0, 44.0, 48.0, 53.0, 56.0, 67.0, 72.0, 75.0, 82.0]",25,7,18,0.72,0.28
316,2501002,"[6.0, 14.0, 19.0, 22.0, 25.0, 29.0, 35.0, 36.0, 38.0, 43.0, 42.0, 44.0, 48.0, 52.0, 65.0, 67.0, 70.0, 72.0, 75.0, 81.0, 82.0, 87.0, 88.0, 89.0, 89.0]",25,13,12,0.48,0.52
317,2501003,"[4.0, 6.0, 8.0, 9.0, 19.0, 23.0, 34.0, 37.0, 40.0, 43.0, 44.0, 44.0, 41.0, 46.0, 63.0, 72.0, 75.0, 76.0, 79.0, 88.0, 88.0]",21,8,13,0.6190476190476191,0.38095238095238093
318,2501004,"[6.0, 9.0, 11.0, 12.0, 25.0, 29.0, 29.0, 36.0, 38.0, 40.0, 43.0, 46.0, 41.0, 46.0, 50.0, 57.0, 59.0, 61.0, 79.0, 80.0, 80.0, 83.0]",22,10,12,0.5454545454545454,0.45454545454545453
319,2501005,"[12.0, 14.0, 23.0, 29.0, 33.0, 35.0, 38.0, 42.0, 43.0, 44.0, 41.0, 45.0, 49.0, 52.0, 54.0, 59.0, 64.0, 65.0, 69.0, 70.0, 71.0, 73.0, 74.0, 74.0, 77.0, 78.0, 80.0, 80.0, 87.0, 89.0]",30,19,11,0.36666666666666664,0.6333333333333333
320,2501006,"[13.0, 15.0, 19.0, 20.0, 24.0, 38.0, 39.0, 40.0, 46.0, 47.0, 49.0, 54.0, 59.0, 70.0, 71.0, 75.0, 76.0, 80.0, 80.0, 86.0]",20,12,8,0.4,0.6
321,2501007,"[1.0, 4.0, 13.0, 14.0, 15.0, 21.0, 35.0, 42.0, 46.0, 50.0, 52.0, 53.0, 62.0, 64.0, 73.0, 80.0, 82.0, 84.0, 86.0, 87.0, 87.0, 88.0]",22,14,8,0.36363636363636365,0.6363636363636364
322,2501008,"[2.0, 6.0, 7.0, 9.0, 19.0, 23.0, 26.0, 27.0, 31.0, 42.0, 45.0, 41.0, 46.0, 48.0, 51.0, 54.0, 56.0, 58.0, 60.0, 62.0, 64.0, 65.0, 68.0, 75.0, 76.0, 79.0, 81.0, 86.0, 86.0, 89.0]",30,19,11,0.36666666666666664,0.6333333333333333
323,2501009,"[9.0, 13.0, 18.0, 20.0, 28.0, 29.0, 35.0, 37.0, 42.0, 41.0, 43.0, 44.0, 50.0, 53.0, 54.0, 69.0, 76.0, 82.0, 85.0, 86.0, 86.0]",21,9,12,0.5714285714285714,0.42857142857142855
324,2501010,"[3.0, 4.0, 20.0, 26.0, 28.0, 29.0, 32.0, 32.0, 38.0, 41.0, 42.0, 43.0, 46.0, 48.0, 50.0, 60.0, 85.0, 87.0, 89.0]",19,7,12,0.631578947368421,0.3684210526315789
325,2501011,"[14.0, 14.0, 21.0, 27.0, 30.0, 31.0, 36.0, 39.0, 40.0, 41.0, 47.0, 54.0, 57.0, 61.0, 62.0, 64.0, 66.0, 69.0, 73.0, 81.0, 81.0, 81.0, 87.0]",23,13,10,0.43478260869565216,0.5652173913043478
326,2501012,"[5.0, 19.0, 22.0, 26.0, 33.0, 36.0, 39.0, 40.0, 42.0, 49.0, 51.0, 55.0, 55.0, 62.0, 73.0, 75.0, 82.0, 84.0]",18,9,9,0.5,0.5
327,2501013,"[5.0, 11.0, 14.0, 16.0, 16.0, 22.0, 22.0, 34.0, 37.0, 45.0, 43.0, 54.0, 57.0, 58.0, 59.0, 59.0, 69.0, 70.0, 70.0, 71.0, 73.0, 77.0, 80.0, 83.0, 86.0, 88.0]",26,16,10,0.38461538461538464,0.6153846153846154
328,2501014,"[5.0, 5.0, 6.0, 7.0, 8.0, 11.0, 12.0, 15.0, 16.0, 24.0, 34.0, 37.0, 44.0, 46.0, 49.0, 74.0, 83.0, 86.0, 87.0, 89.0, 90.0]",21,8,13,0.6190476190476191,0.38095238095238093
329,2501015,"[9.0, 16.0, 18.0, 19.0, 21.0, 23.0, 25.0, 26.0, 29.0, 29.0, 31.0, 38.0, 38.0, 46.0, 48.0, 44.0, 49.0, 51.0, 53.0, 54.0, 66.0, 73.0, 84.0, 84.0, 86.0, 88.0]",26,12,14,0.5384615384615384,0.46153846153846156
330,2501016,"[1.0, 2.0, 5.0, 10.0, 21.0, 23.0, 24.0, 26.0, 27.0, 28.0, 31.0, 36.0, 43.0, 40.0, 47.0, 49.0, 54.0, 55.0, 55.0, 56.0, 57.0, 57.0, 58.0, 59.0, 61.0, 62.0, 67.0, 69.0, 71.0, 75.0, 75.0, 78.0, 83.0, 84.0]",34,20,14,0.4117647058823529,0.5882352941176471
331,2501017,"[1.0, 1.0, 4.0, 6.0, 10.0, 11.0, 12.0, 15.0, 26.0, 32.0, 38.0, 39.0, 40.0, 41.0, 60.0, 61.0, 63.0, 68.0, 69.0, 70.0, 73.0, 83.0, 85.0]",23,9,14,0.6086956521739131,0.391304347826087
332,2501018,"[19.0, 27.0, 30.0, 32.0, 34.0, 35.0, 37.0, 38.0, 40.0, 43.0, 40.0, 42.0, 52.0, 52.0, 54.0, 57.0, 63.0, 64.0, 64.0, 64.0, 67.0, 69.0, 73.0, 75.0, 84.0]",25,13,12,0.48,0.52
333,2501019,"[1.0, 9.0, 16.0, 18.0, 20.0, 22.0, 26.0, 27.0, 28.0, 29.0, 32.0, 35.0, 36.0, 40.0, 44.0, 45.0, 47.0, 50.0, 53.0, 54.0, 57.0, 58.0, 64.0, 74.0, 76.0, 77.0, 80.0, 84.0, 84.0, 85.0]",30,15,15,0.5,0.5
334,2501020,"[1.0, 2.0, 18.0, 23.0, 25.0, 28.0, 43.0, 44.0, 50.0, 54.0, 60.0, 61.0, 66.0, 80.0, 82.0, 84.0, 86.0]",17,9,8,0.47058823529411764,0.5294117647058824
335,2501021,"[3.0, 8.0, 14.0, 15.0, 27.0, 37.0, 40.0, 42.0, 44.0, 47.0, 60.0, 64.0, 68.0, 72.0, 75.0, 77.0, 80.0, 83.0, 85.0, 86.0, 86.0, 88.0]",22,13,9,0.4090909090909091,0.5909090909090909
336,2501022,"[7.0, 17.0, 18.0, 26.0, 27.0, 28.0, 33.0, 33.0, 39.0, 41.0, 42.0, 43.0, 43.0, 40.0, 47.0, 48.0, 51.0, 55.0, 59.0, 62.0, 65.0, 66.0, 67.0, 71.0, 79.0, 79.0, 82.0, 82.0, 85.0, 85.0, 88.0]",31,17,14,0.45161290322580644,0.5483870967741935
337,2501023,"[3.0, 7.0, 9.0, 12.0, 20.0, 27.0, 29.0, 30.0, 32.0, 44.0, 45.0, 49.0, 51.0, 55.0, 57.0, 63.0, 65.0, 72.0, 73.0, 77.0, 78.0, 81.0, 88.0]",23,13,10,0.43478260869565216,0.5652173913043478
338,2501024,"[10.0, 14.0, 20.0, 33.0, 36.0, 39.0, 42.0, 43.0, 45.0, 46.0, 47.0, 47.0, 48.0, 51.0, 53.0, 57.0, 58.0, 59.0, 61.0, 62.0, 68.0, 71.0, 74.0, 77.0, 82.0, 87.0]",26,18,8,0.3076923076923077,0.6923076923076923
339,2501025,"[3.0, 7.0, 26.0, 30.0, 38.0, 40.0, 40.0, 42.0, 43.0, 45.0, 46.0, 51.0, 56.0, 63.0, 68.0, 69.0, 72.0, 73.0, 75.0, 77.0, 82.0, 88.0]",22,13,9,0.4090909090909091,0.5909090909090909
340,2501026,"[2.0, 9.0, 20.0, 23.0, 27.0, 28.0, 34.0, 43.0, 45.0, 40.0, 50.0, 55.0, 56.0, 57.0, 62.0, 63.0, 69.0, 71.0, 73.0, 85.0]",20,11,9,0.45,0.55
341,2501027,"[1.0, 1.0, 11.0, 19.0, 24.0, 26.0, 28.0, 32.0, 33.0, 36.0, 38.0, 40.0, 42.0, 44.0, 47.0, 51.0, 52.0, 55.0, 55.0, 58.0, 64.0, 66.0, 80.0, 83.0, 84.0, 85.0, 86.0]",27,13,14,0.5185185185185185,0.48148148148148145
342,2501028,"[4.0, 7.0, 9.0, 14.0, 18.0, 20.0, 21.0, 28.0, 38.0, 39.0, 45.0, 46.0, 44.0, 46.0, 59.0, 62.0, 67.0, 68.0, 74.0, 80.0, 83.0, 84.0, 86.0]",23,12,11,0.4782608695652174,0.5217391304347826
343,2501029,"[11.0, 13.0, 16.0, 19.0, 20.0, 21.0, 30.0, 33.0, 41.0, 45.0, 49.0, 54.0, 56.0, 58.0, 65.0, 66.0, 67.0, 71.0, 76.0, 82.0, 84.0]",21,12,9,0.42857142857142855,0.5714285714285714
344,2501030,"[5.0, 6.0, 10.0, 13.0, 14.0, 28.0, 35.0, 37.0, 38.0, 40.0, 44.0, 46.0, 63.0, 66.0, 68.0, 71.0, 72.0, 74.0, 82.0, 85.0, 86.0, 87.0]",22,11,11,0.5,0.5
345,2501031,"[5.0, 6.0, 20.0, 21.0, 23.0, 30.0, 39.0, 46.0, 40.0, 51.0, 55.0, 64.0, 71.0, 72.0, 75.0, 86.0, 86.0, 87.0]",18,10,8,0.4444444444444444,0.5555555555555556
346,2501032,"[5.0, 8.0, 9.0, 23.0, 41.0, 52.0, 54.0, 58.0, 61.0, 65.0, 68.0, 69.0, 71.0, 74.0, 78.0, 82.0, 83.0, 84.0, 86.0, 88.0, 89.0]",21,16,5,0.23809523809523808,0.7619047619047619
347,2501033,"[3.0, 14.0, 19.0, 20.0, 24.0, 26.0, 28.0, 29.0, 31.0, 37.0, 39.0, 41.0, 43.0, 41.0, 44.0, 44.0, 46.0, 53.0, 55.0, 58.0, 64.0, 65.0, 68.0, 69.0, 71.0, 80.0, 84.0]",27,11,16,0.5925925925925926,0.4074074074074074
348,2501034,"[3.0, 5.0, 6.0, 10.0, 11.0, 17.0, 19.0, 23.0, 29.0, 34.0, 35.0, 39.0, 41.0, 41.0, 50.0, 51.0, 53.0, 55.0, 55.0, 56.0, 57.0, 58.0, 61.0, 62.0, 66.0, 68.0, 70.0, 71.0, 72.0, 74.0, 78.0, 81.0]",32,18,14,0.4375,0.5625
349,2501035,"[0.0, 3.0, 5.0, 7.0, 8.0, 11.0, 13.0, 23.0, 29.0, 38.0, 44.0, 40.0, 42.0, 54.0, 58.0, 59.0, 67.0, 68.0, 70.0, 74.0, 76.0, 81.0, 83.0, 87.0]",24,11,13,0.5416666666666666,0.4583333333333333
350,2501036,"[1.0, 2.0, 10.0, 11.0, 15.0, 16.0, 24.0, 29.0, 35.0, 37.0, 42.0, 43.0, 43.0, 44.0, 46.0, 52.0, 53.0, 55.0, 60.0, 66.0, 77.0, 84.0, 86.0, 89.0]",24,10,14,0.5833333333333334,0.4166666666666667
351,2501037,"[0.0, 1.0, 4.0, 10.0, 11.0, 13.0, 16.0, 17.0, 27.0, 33.0, 34.0, 35.0, 36.0, 38.0, 42.0, 44.0, 43.0, 44.0, 45.0, 47.0, 50.0, 57.0, 61.0, 62.0, 64.0, 69.0, 70.0, 71.0, 74.0, 82.0, 87.0]",31,13,18,0.5806451612903226,0.41935483870967744
352,2501038,"[4.0, 25.0, 30.0, 39.0, 43.0, 45.0, 42.0, 43.0, 50.0, 51.0, 54.0, 55.0, 56.0, 57.0, 66.0, 69.0, 70.0, 73.0, 80.0, 82.0]",20,13,7,0.35,0.65
353,2501039,"[4.0, 8.0, 9.0, 11.0, 13.0, 19.0, 21.0, 24.0, 32.0, 36.0, 38.0, 58.0, 69.0, 73.0, 76.0, 77.0, 78.0, 79.0, 81.0]",19,8,11,0.5789473684210527,0.42105263157894735
354,2501040,"[2.0, 6.0, 7.0, 9.0, 9.0, 21.0, 34.0, 38.0, 39.0, 40.0, 42.0, 43.0, 41.0, 45.0, 45.0, 46.0, 48.0, 52.0, 61.0, 72.0, 74.0, 76.0, 80.0, 81.0, 82.0, 83.0, 85.0, 87.0, 88.0]",29,16,13,0.4482758620689655,0.5517241379310345
355,2501041,"[1.0, 4.0, 11.0, 22.0, 29.0, 44.0, 43.0, 44.0, 44.0, 45.0, 53.0, 55.0, 59.0, 61.0, 66.0, 71.0, 71.0, 72.0, 76.0, 81.0, 82.0, 82.0, 86.0]",23,14,9,0.391304347826087,0.6086956521739131
356,2501042,"[10.0, 11.0, 18.0, 19.0, 29.0, 34.0, 40.0, 42.0, 45.0, 41.0, 55.0, 59.0, 63.0, 64.0, 66.0, 72.0, 73.0, 74.0, 77.0, 80.0, 84.0, 85.0]",22,13,9,0.4090909090909091,0.5909090909090909
357,2501043,"[1.0, 9.0, 10.0, 12.0, 21.0, 24.0, 26.0, 32.0, 39.0, 44.0, 47.0, 49.0, 56.0, 62.0, 65.0, 66.0, 72.0, 79.0, 84.0, 85.0, 87.0]",21,11,10,0.47619047619047616,0.5238095238095238
358,2501044,"[2.0, 6.0, 8.0, 26.0, 28.0, 31.0, 31.0, 33.0, 39.0, 42.0, 43.0, 47.0, 47.0, 48.0, 56.0, 59.0, 60.0, 62.0, 66.0, 68.0, 75.0, 80.0, 81.0, 82.0, 83.0, 84.0, 87.0]",27,16,11,0.4074074074074074,0.5925925925925926
359,2501045,"[2.0, 3.0, 6.0, 8.0, 12.0, 12.0, 19.0, 20.0, 23.0, 28.0, 34.0, 41.0, 43.0, 46.0, 45.0, 47.0, 48.0, 51.0, 55.0, 64.0, 66.0, 68.0, 70.0, 72.0, 78.0, 78.0, 79.0, 81.0, 87.0]",29,16,13,0.4482758620689655,0.5517241379310345
360,2501046,"[4.0, 5.0, 7.0, 20.0, 22.0, 23.0, 25.0, 27.0, 28.0, 29.0, 34.0, 35.0, 36.0, 42.0, 45.0, 41.0, 43.0, 45.0, 46.0, 53.0, 55.0, 59.0, 61.0, 64.0, 66.0, 68.0, 70.0, 72.0, 85.0]",29,13,16,0.5517241379310345,0.4482758620689655
361,2501047,"[3.0, 12.0, 18.0, 24.0, 29.0, 30.0, 42.0, 43.0, 43.0, 44.0, 50.0, 53.0, 63.0, 66.0, 72.0, 74.0, 87.0]",17,7,10,0.5882352941176471,0.4117647058823529
362,2501048,"[1.0, 3.0, 5.0, 6.0, 11.0, 12.0, 14.0, 23.0, 26.0, 32.0, 35.0, 37.0, 37.0, 46.0, 47.0, 41.0, 42.0, 45.0, 47.0, 50.0, 53.0, 56.0, 60.0, 61.0, 70.0, 72.0, 74.0, 83.0]",28,13,15,0.5357142857142857,0.4642857142857143
363,2501049,"[6.0, 9.0, 17.0, 18.0, 20.0, 20.0, 23.0, 26.0, 27.0, 28.0, 34.0, 40.0, 42.0, 44.0, 42.0, 43.0, 44.0, 44.0, 45.0, 47.0, 48.0, 49.0, 52.0, 55.0, 55.0, 56.0, 57.0, 57.0, 61.0, 67.0, 73.0, 75.0, 77.0, 87.0, 87.0]",35,17,18,0.5142857142857142,0.4857142857142857
364,2501050,"[5.0, 9.0, 13.0, 13.0, 15.0, 21.0, 26.0, 29.0, 31.0, 33.0, 47.0, 59.0, 66.0, 68.0, 71.0, 72.0, 80.0, 82.0, 84.0]",19,9,10,0.5263157894736842,0.47368421052631576
365,2501051,"[3.0, 6.0, 18.0, 19.0, 21.0, 31.0, 35.0, 40.0, 40.0, 41.0, 44.0, 45.0, 40.0, 45.0, 48.0, 51.0, 54.0, 62.0, 66.0, 68.0, 70.0, 77.0, 80.0, 84.0, 84.0, 89.0]",26,14,12,0.46153846153846156,0.5384615384615384
366,2501052,"[1.0, 10.0, 15.0, 18.0, 20.0, 26.0, 27.0, 32.0, 37.0, 43.0, 44.0, 59.0, 65.0, 71.0, 73.0, 75.0, 79.0, 81.0, 82.0]",19,8,11,0.5789473684210527,0.42105263157894735
367,2501053,"[1.0, 3.0, 7.0, 8.0, 11.0, 13.0, 22.0, 24.0, 30.0, 30.0, 34.0, 37.0, 38.0, 39.0, 43.0, 43.0, 44.0, 41.0, 42.0, 49.0, 58.0, 60.0, 65.0, 67.0, 72.0, 72.0, 80.0, 84.0]",28,9,19,0.6785714285714286,0.32142857142857145
368,2501054,"[1.0, 9.0, 13.0, 15.0, 16.0, 17.0, 18.0, 23.0, 28.0, 30.0, 32.0, 33.0, 42.0, 43.0, 45.0, 48.0, 51.0, 59.0, 61.0, 72.0, 82.0, 83.0, 86.0, 87.0]",24,10,14,0.5833333333333334,0.4166666666666667
369,2501055,"[3.0, 6.0, 10.0, 11.0, 11.0, 14.0, 14.0, 17.0, 18.0, 19.0, 24.0, 25.0, 27.0, 31.0, 34.0, 34.0, 37.0, 38.0, 39.0, 40.0, 44.0, 40.0, 41.0, 43.0, 46.0, 46.0, 47.0, 51.0, 51.0, 54.0, 54.0, 55.0, 58.0, 62.0, 63.0, 64.0, 71.0, 71.0, 75.0, 76.0, 77.0, 79.0, 82.0, 87.0, 90.0, 90.0]",46,22,24,0.5217391304347826,0.4782608695652174
370,2501056,"[1.0, 5.0, 7.0, 8.0, 8.0, 9.0, 9.0, 10.0, 18.0, 19.0, 22.0, 23.0, 25.0, 34.0, 36.0, 37.0, 38.0, 40.0, 45.0, 45.0, 45.0, 46.0, 49.0, 51.0, 55.0, 63.0, 69.0, 75.0, 77.0, 79.0, 80.0, 81.0, 84.0, 85.0]",34,16,18,0.5294117647058824,0.47058823529411764
371,2501057,"[5.0, 7.0, 18.0, 21.0, 23.0, 24.0, 25.0, 27.0, 29.0, 40.0, 42.0, 47.0, 41.0, 42.0, 46.0, 51.0, 54.0, 56.0, 59.0, 60.0, 65.0, 66.0, 67.0, 80.0]",24,11,13,0.5416666666666666,0.4583333333333333
372,2501058,"[1.0, 1.0, 4.0, 7.0, 7.0, 10.0, 14.0, 20.0, 21.0, 22.0, 26.0, 30.0, 36.0, 40.0, 42.0, 44.0, 47.0, 47.0, 48.0, 49.0, 49.0, 57.0, 58.0, 63.0, 65.0, 66.0, 67.0, 73.0, 76.0, 89.0]",30,14,16,0.5333333333333333,0.4666666666666667
373,2501059,"[1.0, 2.0, 2.0, 3.0, 13.0, 19.0, 22.0, 28.0, 31.0, 32.0, 36.0, 37.0, 39.0, 41.0, 42.0, 47.0, 49.0, 56.0, 56.0, 61.0, 78.0, 81.0, 83.0, 87.0]",24,9,15,0.625,0.375
374,2501060,"[7.0, 13.0, 13.0, 22.0, 26.0, 29.0, 30.0, 33.0, 44.0, 44.0, 45.0, 46.0, 47.0, 49.0, 60.0, 61.0, 64.0, 66.0, 68.0, 71.0, 75.0, 75.0, 76.0, 83.0, 84.0]",25,15,10,0.4,0.6
375,2501061,"[6.0, 8.0, 16.0, 27.0, 35.0, 39.0, 44.0, 44.0, 54.0, 55.0, 58.0, 59.0, 60.0, 61.0, 63.0, 67.0, 71.0, 76.0]",18,10,8,0.4444444444444444,0.5555555555555556
376,2501062,"[10.0, 19.0, 21.0, 23.0, 27.0, 28.0, 29.0, 31.0, 37.0, 41.0, 42.0, 42.0, 43.0, 46.0, 48.0, 54.0, 58.0, 62.0, 67.0, 75.0, 77.0, 79.0]",22,9,13,0.5909090909090909,0.4090909090909091
377,2501063,"[8.0, 14.0, 15.0, 20.0, 35.0, 38.0, 46.0, 53.0, 55.0, 77.0, 83.0]",11,5,6,0.5454545454545454,0.45454545454545453
378,2501064,"[2.0, 4.0, 7.0, 16.0, 18.0, 23.0, 30.0, 33.0, 36.0, 43.0, 45.0, 41.0, 50.0, 59.0, 63.0, 64.0, 70.0, 73.0, 76.0, 82.0, 84.0, 87.0, 88.0]",23,12,11,0.4782608695652174,0.5217391304347826
379,2501065,"[0.0, 3.0, 5.0, 9.0, 10.0, 13.0, 14.0, 16.0, 18.0, 23.0, 24.0, 26.0, 27.0, 32.0, 35.0, 40.0, 43.0, 44.0, 41.0, 51.0, 52.0, 56.0, 61.0, 62.0, 76.0]",25,6,19,0.76,0.24
