,matchId,shots,total shots,shots in second half,shots in first half,first half shot density,second half shot density
0,2500686,"[10.0, 14.0, 26.0, 30.0, 33.0, 35.0, 42.0, 47.0, 51.0, 52.0, 66.0, 77.0, 77.0, 83.0, 83.0]",15,8,7,0.4666666666666667,0.5333333333333333
1,2500687,"[2.0, 9.0, 14.0, 21.0, 21.0, 24.0, 27.0, 31.0, 37.0, 42.0, 44.0, 49.0, 50.0, 53.0, 64.0, 77.0, 80.0, 84.0, 86.0, 86.0]",20,9,11,0.55,0.45
2,2500688,"[1.0, 3.0, 9.0, 22.0, 23.0, 39.0, 46.0, 49.0, 50.0, 55.0, 79.0, 81.0, 82.0, 82.0, 85.0, 86.0]",16,10,6,0.375,0.625
3,2500689,"[4.0, 11.0, 16.0, 18.0, 19.0, 24.0, 25.0, 26.0, 40.0, 43.0, 41.0, 43.0, 45.0, 45.0, 46.0, 48.0, 52.0, 55.0, 57.0, 64.0, 67.0, 74.0, 75.0, 80.0, 84.0, 84.0, 84.0]",27,15,12,0.4444444444444444,0.5555555555555556
4,2500690,"[3.0, 14.0, 18.0, 21.0, 21.0, 32.0, 34.0, 42.0, 43.0, 60.0, 65.0, 69.0, 75.0, 79.0]",14,5,9,0.6428571428571429,0.35714285714285715
5,2500691,"[4.0, 6.0, 10.0, 12.0, 14.0, 17.0, 24.0, 28.0, 40.0, 45.0, 47.0, 53.0, 64.0, 81.0, 83.0, 87.0]",16,7,9,0.5625,0.4375
6,2500692,"[5.0, 7.0, 8.0, 9.0, 11.0, 13.0, 30.0, 32.0, 33.0, 34.0, 38.0, 45.0, 49.0, 53.0, 55.0, 61.0, 64.0]",17,6,11,0.6470588235294118,0.35294117647058826
7,2500693,"[3.0, 5.0, 5.0, 10.0, 17.0, 17.0, 19.0, 22.0, 24.0, 29.0, 34.0, 37.0, 41.0, 49.0, 53.0, 59.0, 62.0, 70.0, 75.0, 83.0, 86.0]",21,8,13,0.6190476190476191,0.38095238095238093
8,2500694,"[3.0, 6.0, 13.0, 16.0, 26.0, 27.0, 29.0, 37.0, 40.0, 44.0, 59.0, 66.0, 75.0, 87.0]",14,4,10,0.7142857142857143,0.2857142857142857
9,2500695,"[3.0, 10.0, 17.0, 18.0, 19.0, 22.0, 22.0, 22.0, 22.0, 22.0, 27.0, 29.0, 31.0, 32.0, 32.0, 36.0, 41.0, 41.0, 49.0, 56.0, 63.0, 75.0, 77.0, 78.0, 80.0, 81.0, 83.0]",27,9,18,0.6666666666666666,0.3333333333333333
10,2500696,"[4.0, 16.0, 17.0, 25.0, 26.0, 27.0, 32.0, 45.0, 47.0, 49.0, 44.0, 51.0, 53.0, 64.0, 65.0, 65.0, 66.0, 70.0, 71.0, 71.0, 78.0]",21,13,8,0.38095238095238093,0.6190476190476191
11,2500697,"[14.0, 28.0, 41.0, 43.0, 43.0, 45.0, 46.0, 53.0, 57.0, 59.0, 67.0, 68.0, 71.0, 78.0, 81.0, 84.0, 86.0, 86.0]",18,13,5,0.2777777777777778,0.7222222222222222
12,2500698,"[2.0, 6.0, 9.0, 13.0, 13.0, 28.0, 30.0, 30.0, 42.0, 47.0, 49.0, 55.0, 61.0, 63.0, 67.0, 75.0]",16,7,9,0.5625,0.4375
13,2500699,"[3.0, 7.0, 7.0, 10.0, 10.0, 19.0, 23.0, 24.0, 37.0, 43.0, 42.0, 42.0, 44.0, 45.0, 48.0, 49.0, 54.0, 57.0, 65.0, 76.0, 78.0, 85.0, 87.0, 87.0, 88.0]",25,12,13,0.52,0.48
14,2500700,"[14.0, 15.0, 19.0, 26.0, 34.0, 35.0, 40.0, 42.0, 45.0, 48.0, 49.0, 54.0, 56.0, 59.0, 59.0, 70.0, 72.0, 72.0, 76.0, 76.0, 77.0, 84.0]",22,14,8,0.36363636363636365,0.6363636363636364
15,2500701,"[4.0, 5.0, 5.0, 7.0, 13.0, 26.0, 32.0, 34.0, 36.0, 38.0, 42.0, 49.0, 50.0, 53.0, 68.0, 69.0, 75.0, 77.0, 78.0, 82.0, 82.0, 83.0, 84.0, 84.0, 86.0]",25,14,11,0.44,0.56
16,2500702,"[4.0, 9.0, 16.0, 17.0, 22.0, 27.0, 27.0, 33.0, 34.0, 38.0, 42.0, 46.0, 43.0, 43.0, 48.0, 52.0, 54.0, 60.0, 60.0, 61.0, 68.0, 69.0, 70.0, 73.0, 80.0, 87.0]",26,13,13,0.5,0.5
17,2500703,"[7.0, 10.0, 16.0, 23.0, 26.0, 30.0, 33.0, 38.0, 41.0, 41.0, 41.0, 44.0, 44.0, 48.0, 63.0, 65.0, 69.0, 71.0, 77.0, 82.0, 88.0, 90.0, 90.0, 90.0]",24,11,13,0.5416666666666666,0.4583333333333333
18,2500704,"[3.0, 7.0, 18.0, 28.0, 33.0, 37.0, 45.0, 46.0, 41.0, 42.0, 43.0, 46.0, 48.0, 48.0, 49.0, 63.0, 65.0, 66.0, 66.0, 68.0, 74.0, 76.0, 78.0, 80.0, 83.0, 83.0, 85.0, 85.0, 87.0]",29,20,9,0.3103448275862069,0.6896551724137931
19,2500705,"[16.0, 17.0, 23.0, 27.0, 38.0, 39.0, 40.0, 40.0, 64.0, 67.0, 71.0, 75.0, 75.0, 79.0, 82.0, 84.0, 86.0]",17,9,8,0.47058823529411764,0.5294117647058824
20,2500706,"[5.0, 11.0, 15.0, 28.0, 36.0, 43.0, 45.0, 48.0, 49.0, 50.0, 56.0, 61.0, 62.0, 63.0, 66.0, 67.0, 71.0, 72.0, 74.0, 78.0, 80.0, 81.0, 82.0, 82.0, 87.0]",25,19,6,0.24,0.76
21,2500707,"[7.0, 9.0, 13.0, 22.0, 31.0, 34.0, 34.0, 41.0, 41.0, 44.0, 50.0, 52.0, 56.0, 63.0, 72.0, 78.0, 79.0, 82.0, 85.0, 85.0]",20,10,10,0.5,0.5
22,2500708,"[5.0, 16.0, 18.0, 21.0, 28.0, 33.0, 42.0, 46.0, 46.0, 55.0, 60.0, 65.0, 67.0, 67.0, 73.0, 74.0, 75.0, 79.0, 86.0, 86.0]",20,13,7,0.35,0.65
23,2500709,"[8.0, 12.0, 30.0, 35.0, 36.0, 42.0, 47.0, 49.0, 53.0, 53.0, 55.0, 55.0, 56.0, 60.0, 62.0, 62.0, 64.0, 65.0, 65.0, 65.0, 68.0, 72.0, 72.0, 76.0, 79.0, 81.0, 84.0, 86.0, 87.0]",29,23,6,0.20689655172413793,0.7931034482758621
24,2500710,"[3.0, 10.0, 21.0, 21.0, 24.0, 32.0, 33.0, 45.0, 46.0, 50.0, 51.0, 58.0, 67.0, 69.0, 71.0, 72.0, 76.0, 77.0, 84.0, 84.0, 84.0, 86.0]",22,15,7,0.3181818181818182,0.6818181818181818
25,2500711,"[2.0, 9.0, 20.0, 21.0, 31.0, 34.0, 35.0, 38.0, 39.0, 41.0, 45.0, 42.0, 42.0, 47.0, 57.0, 57.0, 63.0, 69.0, 70.0, 71.0, 76.0, 78.0, 79.0, 83.0, 85.0, 86.0]",26,14,12,0.46153846153846156,0.5384615384615384
26,2500712,"[1.0, 11.0, 11.0, 14.0, 17.0, 18.0, 21.0, 25.0, 29.0, 30.0, 30.0, 33.0, 33.0, 35.0, 41.0, 44.0, 44.0, 47.0, 50.0, 66.0, 67.0, 72.0, 72.0, 76.0, 78.0, 83.0, 85.0, 86.0]",28,11,17,0.6071428571428571,0.39285714285714285
27,2500713,"[9.0, 11.0, 14.0, 25.0, 29.0, 34.0, 37.0, 37.0, 41.0, 44.0, 44.0, 46.0, 40.0, 42.0, 45.0, 45.0, 48.0, 49.0, 56.0, 63.0, 64.0, 69.0, 78.0, 88.0]",24,11,13,0.5416666666666666,0.4583333333333333
28,2500714,"[4.0, 14.0, 15.0, 16.0, 22.0, 22.0, 24.0, 32.0, 42.0, 42.0, 50.0, 52.0, 57.0, 57.0, 61.0, 63.0, 66.0, 66.0, 74.0, 74.0, 78.0, 80.0, 82.0, 84.0, 86.0]",25,15,10,0.4,0.6
29,2500715,"[1.0, 17.0, 24.0, 24.0, 37.0, 39.0, 42.0, 46.0, 44.0, 44.0, 50.0, 52.0, 58.0, 67.0, 71.0, 76.0]",16,7,9,0.5625,0.4375
30,2500716,"[1.0, 5.0, 6.0, 20.0, 25.0, 26.0, 27.0, 28.0, 30.0, 36.0, 39.0, 45.0, 46.0, 41.0, 51.0, 53.0, 57.0, 66.0, 72.0, 77.0, 77.0, 82.0]",22,10,12,0.5454545454545454,0.45454545454545453
31,2500717,"[2.0, 4.0, 17.0, 19.0, 26.0, 36.0, 37.0, 44.0, 46.0, 48.0, 41.0, 44.0, 49.0, 49.0, 50.0, 51.0, 52.0, 54.0, 54.0, 55.0, 63.0, 69.0, 76.0, 77.0, 85.0]",25,15,10,0.4,0.6
32,2500718,"[4.0, 5.0, 10.0, 16.0, 27.0, 39.0, 42.0, 47.0, 52.0, 52.0, 57.0, 60.0, 63.0, 76.0, 78.0, 82.0]",16,9,7,0.4375,0.5625
33,2500719,"[1.0, 2.0, 6.0, 11.0, 14.0, 21.0, 25.0, 25.0, 27.0, 29.0, 31.0, 43.0, 44.0, 44.0, 48.0, 58.0, 66.0, 70.0, 71.0, 74.0, 77.0, 78.0, 82.0, 85.0, 86.0, 89.0]",26,12,14,0.5384615384615384,0.46153846153846156
34,2500720,"[20.0, 25.0, 26.0, 33.0, 36.0, 38.0, 45.0, 44.0, 46.0, 54.0, 56.0, 62.0, 66.0, 68.0, 80.0, 81.0, 83.0]",17,10,7,0.4117647058823529,0.5882352941176471
35,2500721,"[5.0, 5.0, 11.0, 11.0, 14.0, 16.0, 23.0, 29.0, 33.0, 38.0, 43.0, 44.0, 44.0, 45.0, 46.0, 46.0, 50.0, 50.0, 51.0, 51.0, 56.0, 57.0, 72.0, 74.0, 77.0, 78.0, 78.0, 81.0, 83.0, 85.0]",30,17,13,0.43333333333333335,0.5666666666666667
36,2500722,"[1.0, 2.0, 2.0, 6.0, 34.0, 41.0, 44.0, 45.0, 43.0, 45.0, 53.0, 55.0, 57.0, 62.0, 62.0, 66.0, 69.0, 69.0, 77.0, 79.0, 80.0]",21,13,8,0.38095238095238093,0.6190476190476191
37,2500723,"[3.0, 10.0, 10.0, 10.0, 16.0, 16.0, 21.0, 23.0, 27.0, 32.0, 40.0, 47.0, 53.0, 58.0, 58.0, 58.0, 59.0, 76.0, 84.0, 86.0]",20,9,11,0.55,0.45
38,2500724,"[8.0, 18.0, 25.0, 30.0, 32.0, 37.0, 44.0, 42.0, 46.0, 54.0, 57.0, 61.0, 67.0, 68.0, 68.0, 76.0, 79.0, 81.0, 83.0, 84.0, 87.0, 88.0, 89.0]",23,15,8,0.34782608695652173,0.6521739130434783
39,2500725,"[1.0, 6.0, 6.0, 11.0, 17.0, 19.0, 20.0, 21.0, 23.0, 35.0, 37.0, 47.0, 48.0, 51.0, 52.0, 54.0, 55.0, 60.0, 62.0, 62.0, 69.0, 73.0]",22,11,11,0.5,0.5
40,2500726,"[8.0, 8.0, 9.0, 18.0, 20.0, 24.0, 29.0, 31.0, 37.0, 44.0, 47.0, 48.0, 49.0, 49.0, 52.0, 64.0, 65.0, 68.0, 73.0]",19,9,10,0.5263157894736842,0.47368421052631576
41,2500727,"[12.0, 15.0, 19.0, 19.0, 21.0, 21.0, 27.0, 28.0, 40.0, 41.0, 43.0, 48.0, 45.0, 47.0, 51.0, 53.0, 56.0, 64.0, 65.0, 82.0, 83.0, 86.0, 87.0, 88.0]",24,13,11,0.4583333333333333,0.5416666666666666
42,2500728,"[3.0, 6.0, 7.0, 18.0, 18.0, 18.0, 25.0, 26.0, 42.0, 42.0, 44.0, 46.0, 48.0, 55.0, 66.0, 66.0, 67.0, 76.0, 84.0]",19,8,11,0.5789473684210527,0.42105263157894735
43,2500729,"[2.0, 8.0, 9.0, 11.0, 16.0, 18.0, 20.0, 34.0, 34.0, 42.0, 42.0, 43.0, 45.0, 46.0, 50.0, 52.0, 63.0, 64.0, 68.0, 73.0, 76.0, 82.0, 85.0]",23,11,12,0.5217391304347826,0.4782608695652174
44,2500730,"[10.0, 13.0, 18.0, 21.0, 26.0, 28.0, 31.0, 34.0, 34.0, 35.0, 36.0, 42.0, 42.0, 42.0, 52.0, 54.0, 56.0, 57.0, 60.0, 61.0, 62.0, 63.0, 65.0, 66.0, 69.0, 80.0, 80.0, 82.0, 82.0]",29,15,14,0.4827586206896552,0.5172413793103449
45,2500731,"[5.0, 6.0, 9.0, 15.0, 31.0, 35.0, 37.0, 37.0, 38.0, 46.0, 46.0, 57.0, 60.0, 66.0, 68.0, 75.0, 76.0, 83.0, 84.0, 86.0]",20,11,9,0.45,0.55
46,2500732,"[2.0, 3.0, 4.0, 4.0, 8.0, 13.0, 17.0, 35.0, 39.0, 41.0, 48.0, 55.0, 68.0, 75.0, 79.0, 79.0]",16,6,10,0.625,0.375
47,2500733,"[1.0, 14.0, 16.0, 19.0, 20.0, 22.0, 24.0, 33.0, 35.0, 40.0, 45.0, 53.0, 57.0, 70.0, 77.0, 77.0, 81.0, 82.0, 84.0, 85.0, 88.0]",21,11,10,0.47619047619047616,0.5238095238095238
48,2500734,"[3.0, 6.0, 12.0, 12.0, 14.0, 24.0, 28.0, 35.0, 38.0, 40.0, 47.0, 51.0, 55.0, 59.0, 68.0, 81.0]",16,6,10,0.625,0.375
49,2500735,"[20.0, 22.0, 24.0, 25.0, 34.0, 34.0, 35.0, 42.0, 44.0, 56.0, 63.0, 66.0, 70.0, 71.0, 74.0, 79.0, 84.0]",17,8,9,0.5294117647058824,0.47058823529411764
50,2500736,"[2.0, 12.0, 15.0, 23.0, 23.0, 28.0, 30.0, 32.0, 35.0, 36.0, 36.0, 45.0, 42.0, 43.0, 47.0, 49.0, 52.0, 58.0, 69.0, 69.0, 70.0, 81.0, 82.0, 87.0]",24,11,13,0.5416666666666666,0.4583333333333333
51,2500737,"[2.0, 11.0, 25.0, 29.0, 32.0, 33.0, 33.0, 37.0, 40.0, 49.0, 51.0, 51.0, 56.0, 60.0, 63.0, 74.0, 77.0, 78.0, 79.0, 90.0, 91.0]",21,12,9,0.42857142857142855,0.5714285714285714
52,2500738,"[1.0, 3.0, 7.0, 9.0, 9.0, 10.0, 13.0, 14.0, 16.0, 17.0, 22.0, 23.0, 28.0, 28.0, 29.0, 30.0, 34.0, 35.0, 42.0, 44.0, 45.0, 49.0, 49.0, 54.0, 57.0, 57.0, 63.0, 66.0, 70.0, 76.0, 82.0, 85.0]",32,12,20,0.625,0.375
53,2500739,"[2.0, 4.0, 9.0, 13.0, 21.0, 22.0, 33.0, 35.0, 37.0, 43.0, 41.0, 42.0, 43.0, 57.0, 61.0, 62.0, 64.0, 69.0, 70.0, 76.0, 81.0, 81.0, 82.0, 85.0, 87.0]",25,12,13,0.52,0.48
54,2500740,"[7.0, 15.0, 15.0, 21.0, 32.0, 34.0, 44.0, 41.0, 44.0, 44.0, 45.0, 51.0, 60.0, 61.0, 69.0, 72.0, 74.0, 76.0, 79.0, 85.0]",20,10,10,0.5,0.5
55,2500741,"[0.0, 9.0, 15.0, 18.0, 30.0, 41.0, 46.0, 46.0, 67.0, 68.0, 69.0, 75.0, 78.0, 79.0, 82.0, 83.0]",16,10,6,0.375,0.625
56,2500742,"[2.0, 6.0, 7.0, 12.0, 29.0, 39.0, 42.0, 44.0, 45.0, 54.0, 56.0, 60.0, 62.0, 64.0, 69.0, 71.0, 81.0, 84.0, 85.0, 87.0]",20,12,8,0.4,0.6
57,2500743,"[6.0, 10.0, 12.0, 30.0, 31.0, 36.0, 39.0, 44.0, 48.0, 41.0, 44.0, 47.0, 50.0, 57.0, 62.0, 66.0, 72.0, 74.0, 81.0]",19,9,10,0.5263157894736842,0.47368421052631576
58,2500744,"[0.0, 2.0, 20.0, 27.0, 30.0, 32.0, 42.0, 44.0, 46.0, 41.0, 42.0, 46.0, 50.0, 50.0, 51.0, 51.0, 53.0, 55.0, 61.0, 63.0, 67.0, 72.0, 74.0, 77.0, 85.0, 88.0, 89.0]",27,17,10,0.37037037037037035,0.6296296296296297
59,2500745,"[4.0, 14.0, 14.0, 32.0, 40.0, 50.0, 57.0, 61.0, 65.0, 70.0, 83.0, 87.0]",12,7,5,0.4166666666666667,0.5833333333333334
60,2500746,"[5.0, 7.0, 10.0, 12.0, 14.0, 18.0, 22.0, 26.0, 30.0, 41.0, 43.0, 47.0, 48.0, 49.0, 51.0, 56.0, 58.0, 59.0, 59.0, 62.0, 64.0, 65.0, 70.0, 77.0, 84.0, 86.0]",26,15,11,0.4230769230769231,0.5769230769230769
61,2500747,"[9.0, 24.0, 26.0, 29.0, 32.0, 34.0, 42.0, 43.0, 51.0, 61.0, 66.0, 69.0, 71.0, 75.0, 80.0, 81.0, 88.0]",17,9,8,0.47058823529411764,0.5294117647058824
62,2500748,"[1.0, 8.0, 16.0, 23.0, 30.0, 33.0, 39.0, 45.0, 43.0, 43.0, 44.0, 48.0, 62.0, 63.0, 66.0, 71.0, 71.0, 73.0, 79.0, 80.0, 85.0]",21,11,10,0.47619047619047616,0.5238095238095238
63,2500749,"[1.0, 4.0, 14.0, 19.0, 19.0, 21.0, 21.0, 42.0, 44.0, 45.0, 42.0, 44.0, 46.0, 55.0, 60.0, 62.0, 63.0, 72.0, 73.0, 74.0]",20,9,11,0.55,0.45
64,2500750,"[4.0, 4.0, 8.0, 17.0, 17.0, 18.0, 20.0, 23.0, 27.0, 28.0, 28.0, 28.0, 32.0, 37.0, 42.0, 43.0, 55.0, 55.0, 56.0, 58.0, 59.0, 59.0, 62.0, 65.0, 65.0, 75.0, 80.0, 84.0, 84.0]",29,13,16,0.5517241379310345,0.4482758620689655
65,2500751,"[13.0, 17.0, 34.0, 35.0, 36.0, 42.0, 44.0, 44.0, 44.0, 49.0, 50.0, 58.0, 63.0, 69.0, 70.0, 71.0, 71.0, 77.0, 82.0, 82.0, 85.0]",21,12,9,0.42857142857142855,0.5714285714285714
66,2500752,"[16.0, 16.0, 23.0, 29.0, 38.0, 44.0, 42.0, 49.0, 53.0, 57.0, 58.0]",11,4,7,0.6363636363636364,0.36363636363636365
67,2500753,"[12.0, 13.0, 15.0, 23.0, 31.0, 33.0, 36.0, 38.0, 42.0, 43.0, 44.0, 49.0, 49.0, 52.0, 54.0, 68.0, 68.0, 79.0, 82.0, 88.0, 89.0, 90.0]",22,11,11,0.5,0.5
68,2500754,"[6.0, 14.0, 37.0, 37.0, 40.0, 46.0, 68.0, 77.0, 82.0, 84.0, 85.0, 85.0, 87.0]",13,8,5,0.38461538461538464,0.6153846153846154
69,2500755,"[9.0, 12.0, 12.0, 18.0, 19.0, 23.0, 24.0, 26.0, 28.0, 36.0, 37.0, 42.0, 46.0, 46.0, 49.0, 50.0, 56.0, 60.0, 64.0, 64.0, 67.0, 69.0, 72.0, 74.0, 77.0, 79.0, 84.0, 85.0, 87.0, 87.0]",30,18,12,0.4,0.6
70,2500756,"[5.0, 8.0, 11.0, 27.0, 28.0, 33.0, 35.0, 42.0, 45.0, 56.0, 71.0, 78.0, 78.0, 80.0, 81.0, 85.0, 87.0]",17,9,8,0.47058823529411764,0.5294117647058824
71,2500757,"[2.0, 4.0, 5.0, 13.0, 20.0, 22.0, 32.0, 36.0, 37.0, 38.0, 41.0, 41.0, 44.0, 41.0, 42.0, 43.0, 47.0, 53.0, 61.0, 62.0, 84.0, 86.0, 86.0, 88.0, 89.0]",25,9,16,0.64,0.36
72,2500758,"[8.0, 24.0, 26.0, 42.0, 43.0, 42.0, 44.0, 46.0, 54.0, 55.0, 61.0, 66.0, 73.0, 76.0, 86.0, 86.0]",16,9,7,0.4375,0.5625
73,2500759,"[1.0, 8.0, 9.0, 13.0, 31.0, 37.0, 39.0, 44.0, 49.0, 54.0, 60.0, 65.0, 66.0]",13,5,8,0.6153846153846154,0.38461538461538464
74,2500760,"[2.0, 7.0, 8.0, 12.0, 13.0, 19.0, 20.0, 26.0, 28.0, 37.0, 40.0, 46.0, 51.0, 54.0, 61.0, 72.0, 79.0, 87.0]",18,7,11,0.6111111111111112,0.3888888888888889
75,2500761,"[2.0, 2.0, 4.0, 13.0, 14.0, 16.0, 18.0, 23.0, 24.0, 29.0, 30.0, 30.0, 31.0, 35.0, 44.0, 42.0, 55.0, 62.0, 67.0, 69.0, 76.0, 87.0]",22,6,16,0.7272727272727273,0.2727272727272727
76,2500762,"[4.0, 6.0, 8.0, 11.0, 11.0, 12.0, 15.0, 15.0, 15.0, 25.0, 25.0, 28.0, 31.0, 38.0, 43.0, 44.0, 44.0, 42.0, 43.0, 47.0, 53.0, 59.0, 60.0, 65.0, 68.0, 75.0, 78.0, 83.0, 83.0, 85.0, 88.0]",31,12,19,0.6129032258064516,0.3870967741935484
77,2500763,"[2.0, 11.0, 21.0, 23.0, 30.0, 31.0, 36.0, 37.0, 37.0, 38.0, 44.0, 40.0, 47.0, 52.0, 54.0, 64.0, 66.0, 73.0, 81.0, 88.0]",20,8,12,0.6,0.4
78,2500764,"[2.0, 7.0, 19.0, 25.0, 28.0, 34.0, 37.0, 43.0, 41.0, 46.0, 63.0, 64.0, 79.0, 81.0, 88.0, 88.0, 88.0]",17,8,9,0.5294117647058824,0.47058823529411764
79,2500765,"[1.0, 4.0, 8.0, 17.0, 19.0, 22.0, 22.0, 26.0, 38.0, 40.0, 40.0, 44.0, 43.0, 47.0, 60.0, 62.0, 63.0, 71.0, 77.0]",19,6,13,0.6842105263157895,0.3157894736842105
80,2500766,"[6.0, 9.0, 18.0, 22.0, 24.0, 24.0, 39.0, 44.0, 47.0, 47.0, 41.0, 46.0, 49.0, 52.0, 52.0, 64.0, 65.0, 67.0, 74.0, 74.0, 76.0, 77.0, 78.0, 86.0]",24,15,9,0.375,0.625
81,2500767,"[1.0, 10.0, 17.0, 25.0, 26.0, 26.0, 27.0, 30.0, 30.0, 33.0, 33.0, 35.0, 38.0, 42.0, 44.0, 45.0, 51.0, 53.0, 58.0, 62.0, 68.0, 73.0, 76.0, 77.0, 80.0, 80.0, 82.0, 85.0, 86.0, 87.0, 87.0]",31,16,15,0.4838709677419355,0.5161290322580645
82,2500768,"[14.0, 18.0, 30.0, 37.0, 38.0, 45.0, 45.0, 47.0, 48.0, 49.0, 52.0, 54.0, 56.0, 58.0, 59.0, 59.0, 60.0, 62.0, 65.0, 65.0, 81.0, 85.0, 85.0, 86.0]",24,19,5,0.20833333333333334,0.7916666666666666
83,2500769,"[6.0, 8.0, 8.0, 11.0, 16.0, 29.0, 32.0, 33.0, 34.0, 45.0, 45.0, 45.0, 48.0, 51.0, 52.0, 52.0, 55.0, 58.0, 58.0, 66.0, 70.0, 78.0, 84.0]",23,14,9,0.391304347826087,0.6086956521739131
84,2500770,"[1.0, 3.0, 8.0, 12.0, 13.0, 19.0, 26.0, 27.0, 29.0, 29.0, 32.0, 33.0, 34.0, 36.0, 42.0, 44.0, 49.0, 53.0, 53.0, 54.0, 62.0, 66.0, 69.0, 75.0]",24,8,16,0.6666666666666666,0.3333333333333333
85,2500771,"[6.0, 6.0, 8.0, 9.0, 11.0, 12.0, 17.0, 20.0, 22.0, 28.0, 29.0, 29.0, 32.0, 33.0, 34.0, 45.0, 50.0, 51.0, 51.0, 58.0, 59.0, 62.0, 62.0, 70.0, 71.0, 71.0, 76.0, 78.0, 78.0, 82.0, 83.0]",31,16,15,0.4838709677419355,0.5161290322580645
86,2500772,"[3.0, 4.0, 5.0, 6.0, 13.0, 17.0, 19.0, 19.0, 26.0, 26.0, 27.0, 27.0, 36.0, 37.0, 40.0, 42.0, 44.0, 49.0, 55.0, 58.0, 60.0, 65.0, 68.0, 75.0, 76.0, 77.0, 78.0]",27,10,17,0.6296296296296297,0.37037037037037035
87,2500773,"[5.0, 6.0, 6.0, 18.0, 20.0, 24.0, 35.0, 36.0, 37.0, 47.0, 41.0, 42.0, 47.0, 48.0, 54.0, 54.0, 57.0, 59.0, 64.0, 65.0, 66.0, 68.0, 68.0, 68.0, 68.0, 77.0, 80.0, 89.0]",28,17,11,0.39285714285714285,0.6071428571428571
88,2500774,"[5.0, 10.0, 12.0, 15.0, 19.0, 31.0, 31.0, 33.0, 35.0, 35.0, 36.0, 36.0, 37.0, 42.0, 44.0, 46.0, 48.0, 50.0, 53.0, 55.0, 58.0, 60.0, 67.0, 69.0, 71.0, 74.0, 74.0, 78.0, 80.0, 81.0, 82.0, 82.0, 82.0, 82.0, 86.0]",35,20,15,0.42857142857142855,0.5714285714285714
89,2500775,"[6.0, 10.0, 18.0, 20.0, 25.0, 29.0, 30.0, 32.0, 34.0, 36.0, 37.0, 40.0, 46.0, 46.0, 56.0, 57.0, 69.0, 74.0, 76.0, 80.0, 87.0]",21,9,12,0.5714285714285714,0.42857142857142855
90,2500776,"[2.0, 3.0, 8.0, 9.0, 12.0, 20.0, 23.0, 28.0, 28.0, 33.0, 33.0, 38.0, 38.0, 39.0, 41.0, 44.0, 46.0, 47.0, 51.0, 53.0, 54.0, 59.0, 62.0, 69.0, 71.0, 84.0]",26,10,16,0.6153846153846154,0.38461538461538464
91,2500777,"[2.0, 10.0, 12.0, 14.0, 32.0, 38.0, 43.0, 44.0, 51.0, 55.0, 57.0, 58.0, 61.0, 93.0]",14,6,8,0.5714285714285714,0.42857142857142855
92,2500778,"[2.0, 6.0, 12.0, 13.0, 15.0, 15.0, 17.0, 24.0, 33.0, 59.0, 62.0, 69.0, 72.0, 73.0, 82.0, 82.0]",16,7,9,0.5625,0.4375
93,2500779,"[5.0, 6.0, 9.0, 16.0, 24.0, 26.0, 27.0, 28.0, 31.0, 31.0, 35.0, 41.0, 45.0, 44.0, 49.0, 54.0, 54.0, 59.0, 60.0, 67.0, 68.0, 77.0, 78.0]",23,10,13,0.5652173913043478,0.43478260869565216
94,2500780,"[1.0, 9.0, 13.0, 17.0, 21.0, 33.0, 34.0, 34.0, 36.0, 36.0, 36.0, 43.0, 45.0, 41.0, 63.0, 63.0, 72.0, 75.0, 85.0]",19,6,13,0.6842105263157895,0.3157894736842105
95,2500781,"[4.0, 9.0, 14.0, 17.0, 27.0, 41.0, 42.0, 53.0, 55.0, 63.0, 64.0, 74.0, 75.0, 81.0, 83.0, 85.0, 87.0]",17,10,7,0.4117647058823529,0.5882352941176471
96,2500782,"[17.0, 19.0, 23.0, 29.0, 30.0, 31.0, 35.0, 36.0, 37.0, 43.0, 44.0, 45.0, 46.0, 46.0, 52.0, 54.0, 54.0, 54.0, 54.0, 58.0, 63.0, 67.0, 70.0, 74.0, 83.0, 84.0, 85.0]",27,16,11,0.4074074074074074,0.5925925925925926
97,2500783,"[2.0, 6.0, 8.0, 11.0, 13.0, 24.0, 26.0, 47.0, 48.0, 48.0, 69.0, 74.0, 75.0, 78.0, 85.0]",15,8,7,0.4666666666666667,0.5333333333333333
98,2500784,"[0.0, 7.0, 8.0, 18.0, 18.0, 19.0, 21.0, 21.0, 24.0, 26.0, 33.0, 38.0, 39.0, 44.0, 44.0, 49.0, 50.0, 55.0, 56.0, 76.0, 80.0, 82.0, 83.0, 86.0, 87.0, 87.0, 88.0]",27,12,15,0.5555555555555556,0.4444444444444444
99,2500785,"[13.0, 17.0, 21.0, 25.0, 26.0, 28.0, 43.0, 47.0, 56.0, 58.0, 60.0, 63.0, 68.0, 73.0, 74.0, 79.0, 82.0, 85.0, 85.0]",19,12,7,0.3684210526315789,0.631578947368421
100,2500786,"[5.0, 8.0, 10.0, 11.0, 22.0, 25.0, 31.0, 44.0, 50.0, 51.0, 52.0, 60.0, 69.0, 71.0, 74.0, 74.0, 74.0, 77.0, 78.0, 82.0, 84.0]",21,13,8,0.38095238095238093,0.6190476190476191
101,2500787,"[7.0, 14.0, 17.0, 26.0, 29.0, 37.0, 38.0, 42.0, 42.0, 43.0, 41.0, 43.0, 53.0, 54.0, 59.0, 65.0, 66.0, 66.0, 80.0, 82.0, 83.0, 85.0, 89.0]",23,11,12,0.5217391304347826,0.4782608695652174
102,2500788,"[3.0, 6.0, 10.0, 20.0, 42.0, 42.0, 51.0, 51.0, 60.0, 62.0, 62.0, 73.0, 81.0, 83.0, 86.0, 86.0, 86.0]",17,11,6,0.35294117647058826,0.6470588235294118
103,2500789,"[2.0, 8.0, 18.0, 22.0, 27.0, 30.0, 33.0, 44.0, 43.0, 44.0, 45.0, 50.0, 59.0, 65.0, 68.0, 73.0, 76.0, 81.0, 87.0]",19,9,10,0.5263157894736842,0.47368421052631576
104,2500790,"[1.0, 2.0, 3.0, 5.0, 23.0, 25.0, 27.0, 30.0, 30.0, 40.0, 41.0, 42.0, 47.0, 50.0, 60.0, 61.0, 70.0, 76.0, 85.0, 88.0, 89.0, 89.0]",22,10,12,0.5454545454545454,0.45454545454545453
105,2500791,"[5.0, 15.0, 20.0, 22.0, 37.0, 44.0, 45.0, 53.0, 59.0, 66.0, 68.0, 70.0, 83.0, 83.0]",14,8,6,0.42857142857142855,0.5714285714285714
106,2500792,"[0.0, 3.0, 12.0, 18.0, 31.0, 42.0, 50.0, 53.0, 55.0, 70.0, 77.0, 82.0, 85.0, 92.0]",14,8,6,0.42857142857142855,0.5714285714285714
107,2500793,"[2.0, 5.0, 9.0, 9.0, 11.0, 11.0, 15.0, 19.0, 23.0, 25.0, 30.0, 36.0, 39.0, 42.0, 42.0, 52.0, 53.0, 56.0, 78.0, 82.0, 83.0, 85.0, 86.0]",23,8,15,0.6521739130434783,0.34782608695652173
108,2500794,"[6.0, 12.0, 13.0, 20.0, 20.0, 23.0, 30.0, 31.0, 39.0, 63.0, 66.0, 69.0, 70.0, 71.0, 72.0, 87.0]",16,7,9,0.5625,0.4375
109,2500795,"[4.0, 12.0, 20.0, 35.0, 40.0, 42.0, 44.0, 52.0, 61.0, 65.0, 72.0, 79.0, 84.0, 85.0]",14,7,7,0.5,0.5
110,2500796,"[4.0, 9.0, 11.0, 12.0, 14.0, 18.0, 24.0, 25.0, 28.0, 30.0, 34.0, 37.0, 43.0, 47.0, 53.0, 55.0, 62.0, 64.0, 74.0, 76.0, 78.0, 81.0]",22,9,13,0.5909090909090909,0.4090909090909091
111,2500797,"[3.0, 15.0, 17.0, 17.0, 17.0, 17.0, 22.0, 24.0, 32.0, 33.0, 34.0, 34.0, 36.0, 40.0, 42.0, 42.0, 42.0, 47.0, 49.0, 50.0, 51.0, 53.0, 53.0, 56.0, 56.0, 57.0, 61.0, 65.0, 70.0, 75.0, 75.0, 77.0, 78.0, 80.0, 82.0, 83.0, 84.0]",37,20,17,0.4594594594594595,0.5405405405405406
112,2500798,"[7.0, 8.0, 10.0, 11.0, 14.0, 19.0, 23.0, 25.0, 29.0, 35.0, 39.0, 40.0, 44.0, 51.0, 52.0, 57.0, 58.0, 61.0, 62.0, 62.0, 63.0, 66.0, 72.0, 73.0, 79.0, 80.0, 81.0]",27,14,13,0.48148148148148145,0.5185185185185185
113,2500799,"[4.0, 9.0, 15.0, 23.0, 25.0, 26.0, 36.0, 39.0, 43.0, 48.0, 49.0, 51.0, 51.0, 61.0, 61.0, 63.0, 64.0, 66.0, 70.0, 72.0, 76.0, 77.0, 79.0, 81.0, 82.0, 84.0]",26,17,9,0.34615384615384615,0.6538461538461539
114,2500800,"[7.0, 17.0, 20.0, 20.0, 26.0, 26.0, 33.0, 35.0, 39.0, 42.0, 50.0, 52.0, 54.0, 60.0, 62.0, 69.0, 76.0, 76.0, 80.0, 83.0]",20,10,10,0.5,0.5
115,2500801,"[4.0, 7.0, 9.0, 13.0, 14.0, 16.0, 32.0, 38.0, 45.0, 49.0, 52.0, 54.0, 60.0, 62.0, 67.0, 73.0, 78.0]",17,9,8,0.47058823529411764,0.5294117647058824
116,2500802,"[2.0, 5.0, 6.0, 7.0, 9.0, 17.0, 17.0, 20.0, 42.0, 47.0, 53.0, 59.0, 62.0, 67.0, 72.0, 73.0, 73.0, 75.0, 77.0, 81.0, 83.0]",21,12,9,0.42857142857142855,0.5714285714285714
117,2500803,"[18.0, 19.0, 29.0, 50.0, 54.0, 57.0, 60.0, 86.0]",8,5,3,0.375,0.625
118,2500804,"[9.0, 10.0, 13.0, 16.0, 23.0, 24.0, 25.0, 27.0, 30.0, 30.0, 34.0, 34.0, 42.0, 44.0, 48.0, 52.0, 41.0, 52.0, 54.0, 55.0, 58.0, 59.0, 72.0, 72.0, 79.0]",25,10,15,0.6,0.4
119,2500805,"[10.0, 16.0, 21.0, 38.0, 44.0, 45.0, 42.0, 46.0, 49.0, 51.0, 54.0, 55.0, 65.0, 66.0, 79.0, 82.0, 83.0, 83.0, 84.0, 85.0, 87.0]",21,15,6,0.2857142857142857,0.7142857142857143
120,2500806,"[12.0, 14.0, 17.0, 29.0, 29.0, 30.0, 33.0, 42.0, 43.0, 43.0, 47.0, 48.0, 49.0, 50.0, 53.0, 54.0, 55.0, 60.0, 62.0, 73.0, 76.0, 78.0, 80.0, 83.0, 85.0]",25,15,10,0.4,0.6
121,2500807,"[2.0, 6.0, 8.0, 9.0, 10.0, 18.0, 24.0, 26.0, 39.0, 42.0, 45.0, 47.0, 49.0, 51.0, 59.0, 64.0, 65.0, 79.0, 86.0, 89.0]",20,10,10,0.5,0.5
122,2500808,"[3.0, 6.0, 9.0, 13.0, 16.0, 23.0, 31.0, 33.0, 35.0, 37.0, 40.0, 41.0, 44.0, 45.0, 48.0, 67.0, 69.0, 69.0, 70.0, 73.0, 75.0, 82.0, 83.0, 86.0, 86.0, 87.0]",26,13,13,0.5,0.5
123,2500809,"[3.0, 16.0, 17.0, 18.0, 22.0, 23.0, 26.0, 27.0, 28.0, 28.0, 29.0, 29.0, 31.0, 44.0, 40.0, 44.0, 47.0, 47.0, 48.0, 51.0, 61.0, 64.0, 69.0, 80.0]",24,8,16,0.6666666666666666,0.3333333333333333
124,2500810,"[4.0, 8.0, 14.0, 19.0, 23.0, 30.0, 34.0, 37.0, 41.0, 47.0, 44.0, 59.0, 64.0, 74.0, 87.0]",15,5,10,0.6666666666666666,0.3333333333333333
125,2500811,"[1.0, 4.0, 4.0, 17.0, 17.0, 20.0, 23.0, 40.0, 41.0, 45.0, 57.0, 58.0, 66.0, 80.0, 84.0, 87.0]",16,7,9,0.5625,0.4375
126,2500812,"[13.0, 14.0, 15.0, 19.0, 20.0, 21.0, 25.0, 28.0, 29.0, 33.0, 34.0, 37.0, 42.0, 45.0, 54.0, 57.0, 59.0, 59.0, 60.0, 65.0, 65.0, 66.0, 69.0, 75.0, 75.0, 76.0, 80.0]",27,14,13,0.48148148148148145,0.5185185185185185
127,2500813,"[5.0, 7.0, 16.0, 17.0, 20.0, 23.0, 26.0, 27.0, 30.0, 30.0, 31.0, 32.0, 37.0, 41.0, 41.0, 47.0, 48.0, 55.0, 60.0, 68.0, 73.0, 74.0, 79.0, 80.0, 83.0, 84.0, 84.0, 86.0]",28,13,15,0.5357142857142857,0.4642857142857143
128,2500814,"[1.0, 1.0, 9.0, 13.0, 26.0, 27.0, 27.0, 34.0, 44.0, 44.0, 45.0, 42.0, 44.0, 57.0, 59.0, 65.0, 77.0, 83.0]",18,6,12,0.6666666666666666,0.3333333333333333
129,2500815,"[2.0, 3.0, 7.0, 8.0, 8.0, 13.0, 19.0, 26.0, 26.0, 33.0, 37.0, 37.0, 42.0, 44.0, 45.0, 45.0, 50.0, 53.0, 57.0, 62.0, 62.0, 69.0, 70.0, 71.0, 73.0, 74.0, 75.0, 76.0, 77.0, 78.0, 80.0]",31,17,14,0.45161290322580644,0.5483870967741935
130,2500816,"[2.0, 6.0, 7.0, 8.0, 15.0, 17.0, 23.0, 34.0, 39.0, 41.0, 46.0, 47.0, 48.0, 49.0, 49.0, 52.0, 60.0, 68.0, 70.0, 74.0, 87.0]",21,11,10,0.47619047619047616,0.5238095238095238
131,2500817,"[18.0, 20.0, 22.0, 25.0, 26.0, 31.0, 34.0, 37.0, 39.0, 41.0, 52.0, 56.0, 58.0, 59.0, 64.0, 66.0, 76.0, 79.0, 84.0, 85.0]",20,10,10,0.5,0.5
132,2500818,"[2.0, 5.0, 8.0, 10.0, 16.0, 19.0, 20.0, 22.0, 27.0, 31.0, 33.0, 34.0, 35.0, 36.0, 45.0, 47.0, 55.0, 61.0, 71.0, 73.0, 74.0, 79.0, 80.0, 86.0, 87.0]",25,11,14,0.56,0.44
133,2500819,"[4.0, 5.0, 11.0, 14.0, 15.0, 27.0, 28.0, 34.0, 38.0, 39.0, 42.0, 43.0, 46.0, 40.0, 41.0, 43.0, 45.0, 50.0, 50.0, 51.0, 54.0, 55.0, 57.0, 60.0, 65.0, 71.0, 72.0, 73.0, 74.0, 80.0, 82.0]",31,16,15,0.4838709677419355,0.5161290322580645
134,2500820,"[2.0, 6.0, 8.0, 8.0, 18.0, 25.0, 39.0, 41.0, 42.0, 42.0, 44.0, 44.0, 63.0, 64.0, 65.0, 65.0, 68.0, 70.0, 79.0, 80.0, 88.0]",21,9,12,0.5714285714285714,0.42857142857142855
135,2500821,"[2.0, 3.0, 4.0, 4.0, 12.0, 15.0, 16.0, 19.0, 25.0, 30.0, 39.0, 39.0, 40.0, 43.0, 43.0, 44.0, 46.0, 47.0, 54.0, 55.0, 56.0, 75.0, 76.0, 82.0, 86.0, 86.0, 87.0]",27,11,16,0.5925925925925926,0.4074074074074074
136,2500822,"[5.0, 10.0, 16.0, 16.0, 19.0, 20.0, 25.0, 26.0, 37.0, 49.0, 53.0, 54.0, 55.0, 60.0, 61.0, 62.0, 63.0, 74.0, 81.0, 84.0]",20,11,9,0.45,0.55
137,2500823,"[3.0, 9.0, 15.0, 17.0, 19.0, 32.0, 40.0, 41.0, 41.0, 45.0, 45.0, 46.0, 45.0, 53.0, 55.0, 57.0, 60.0, 73.0, 73.0, 78.0, 82.0, 85.0]",22,13,9,0.4090909090909091,0.5909090909090909
138,2500824,"[10.0, 11.0, 16.0, 24.0, 26.0, 33.0, 38.0, 41.0, 44.0, 48.0, 49.0, 51.0, 60.0, 62.0, 68.0, 89.0]",16,7,9,0.5625,0.4375
139,2500825,"[2.0, 4.0, 11.0, 14.0, 15.0, 18.0, 22.0, 24.0, 27.0, 37.0, 43.0, 48.0, 45.0, 53.0, 55.0, 59.0, 74.0]",17,6,11,0.6470588235294118,0.35294117647058826
140,2500826,"[7.0, 8.0, 14.0, 26.0, 30.0, 32.0, 34.0, 39.0, 44.0, 44.0, 45.0, 50.0, 53.0, 56.0, 59.0, 67.0, 70.0, 71.0, 74.0, 80.0, 80.0, 86.0]",22,12,10,0.45454545454545453,0.5454545454545454
141,2500827,"[7.0, 13.0, 33.0, 37.0, 42.0, 46.0, 41.0, 41.0, 43.0, 45.0, 47.0, 65.0, 68.0, 75.0, 76.0, 78.0, 87.0]",17,9,8,0.47058823529411764,0.5294117647058824
142,2500828,"[2.0, 4.0, 5.0, 16.0, 16.0, 19.0, 20.0, 31.0, 38.0, 43.0, 45.0, 44.0, 46.0, 51.0, 54.0, 58.0, 61.0, 63.0, 66.0, 71.0, 79.0, 87.0]",22,11,11,0.5,0.5
143,2500829,"[1.0, 7.0, 13.0, 14.0, 23.0, 38.0, 41.0, 43.0, 42.0, 59.0, 59.0, 68.0, 74.0, 77.0, 78.0]",15,6,9,0.6,0.4
144,2500830,"[1.0, 11.0, 14.0, 20.0, 20.0, 31.0, 33.0, 35.0, 35.0, 39.0, 47.0, 48.0, 54.0, 56.0, 58.0, 72.0, 74.0, 79.0, 79.0, 81.0, 81.0, 83.0, 83.0, 84.0]",24,14,10,0.4166666666666667,0.5833333333333334
145,2500831,"[13.0, 16.0, 17.0, 22.0, 28.0, 29.0, 30.0, 33.0, 35.0, 37.0, 42.0, 40.0, 40.0, 44.0, 46.0, 53.0, 57.0, 58.0, 60.0, 61.0, 66.0, 72.0, 76.0, 78.0, 80.0, 85.0, 85.0]",27,13,14,0.5185185185185185,0.48148148148148145
146,2500832,"[2.0, 6.0, 8.0, 13.0, 14.0, 17.0, 19.0, 25.0, 32.0, 41.0, 42.0, 45.0, 49.0, 49.0, 62.0, 62.0, 62.0, 66.0, 71.0, 73.0, 78.0, 78.0, 87.0]",23,12,11,0.4782608695652174,0.5217391304347826
147,2500833,"[4.0, 11.0, 14.0, 19.0, 22.0, 27.0, 29.0, 37.0, 41.0, 44.0, 45.0, 44.0, 44.0, 52.0, 55.0, 65.0, 67.0, 76.0, 77.0, 78.0, 80.0, 85.0]",22,10,12,0.5454545454545454,0.45454545454545453
148,2500834,"[5.0, 6.0, 7.0, 22.0, 31.0, 36.0, 42.0, 47.0, 43.0, 49.0, 49.0, 49.0, 56.0, 67.0, 76.0, 79.0, 79.0, 82.0, 83.0]",19,11,8,0.42105263157894735,0.5789473684210527
149,2500835,"[2.0, 12.0, 23.0, 24.0, 27.0, 30.0, 37.0, 41.0, 44.0, 48.0, 50.0, 51.0, 51.0, 51.0, 54.0, 64.0, 68.0, 73.0, 86.0]",19,10,9,0.47368421052631576,0.5263157894736842
150,2500836,"[4.0, 7.0, 9.0, 20.0, 21.0, 26.0, 26.0, 27.0, 27.0, 28.0, 33.0, 38.0, 48.0, 55.0, 62.0, 63.0, 63.0, 64.0, 66.0, 67.0, 69.0, 70.0, 73.0, 75.0, 78.0, 81.0, 84.0, 84.0, 86.0, 88.0]",30,18,12,0.4,0.6
151,2500837,"[7.0, 10.0, 13.0, 13.0, 19.0, 19.0, 23.0, 28.0, 30.0, 33.0, 35.0, 40.0, 41.0, 43.0, 42.0, 43.0, 46.0, 54.0, 59.0, 61.0, 66.0, 68.0, 70.0, 81.0, 83.0, 84.0]",26,10,16,0.6153846153846154,0.38461538461538464
152,2500838,"[6.0, 14.0, 26.0, 27.0, 28.0, 31.0, 32.0, 34.0, 40.0, 43.0, 45.0, 48.0, 58.0, 68.0, 85.0, 85.0]",16,6,10,0.625,0.375
153,2500839,"[2.0, 14.0, 26.0, 28.0, 39.0, 47.0, 50.0, 70.0, 81.0, 83.0]",10,5,5,0.5,0.5
154,2500840,"[0.0, 9.0, 13.0, 17.0, 28.0, 41.0, 43.0, 43.0, 65.0, 72.0, 78.0, 81.0, 82.0, 86.0, 89.0]",15,7,8,0.5333333333333333,0.4666666666666667
155,2500841,"[4.0, 5.0, 10.0, 17.0, 19.0, 21.0, 21.0, 22.0, 26.0, 26.0, 28.0, 32.0, 32.0, 34.0, 42.0, 45.0, 45.0, 47.0, 55.0, 58.0, 64.0, 66.0, 74.0, 83.0, 89.0]",25,10,15,0.6,0.4
156,2500842,"[3.0, 8.0, 10.0, 21.0, 21.0, 22.0, 24.0, 35.0, 42.0, 47.0, 41.0, 44.0, 46.0, 49.0, 55.0, 58.0, 60.0, 65.0, 67.0, 68.0, 70.0, 73.0, 75.0, 75.0, 79.0, 80.0, 81.0, 87.0]",28,17,11,0.39285714285714285,0.6071428571428571
157,2500843,"[6.0, 9.0, 10.0, 11.0, 22.0, 24.0, 25.0, 28.0, 31.0, 37.0, 37.0, 42.0, 41.0, 48.0, 52.0, 54.0, 54.0, 55.0, 60.0, 60.0, 61.0, 62.0, 65.0, 71.0, 71.0, 72.0, 79.0, 80.0, 81.0, 86.0, 87.0, 89.0]",32,19,13,0.40625,0.59375
158,2500844,"[6.0, 12.0, 17.0, 17.0, 18.0, 34.0, 39.0, 41.0, 42.0, 44.0, 41.0, 43.0, 43.0, 47.0, 48.0, 57.0, 59.0, 61.0, 62.0, 71.0, 76.0, 78.0, 78.0, 80.0, 85.0, 86.0, 93.0, 94.0]",28,15,13,0.4642857142857143,0.5357142857142857
159,2500845,"[8.0, 11.0, 17.0, 21.0, 21.0, 25.0, 25.0, 27.0, 28.0, 32.0, 34.0, 43.0, 41.0, 45.0, 48.0, 57.0, 64.0, 65.0, 76.0, 78.0, 81.0, 90.0]",22,9,13,0.5909090909090909,0.4090909090909091
160,2500846,"[8.0, 11.0, 12.0, 16.0, 20.0, 21.0, 32.0, 40.0, 42.0, 45.0, 49.0, 57.0, 63.0, 73.0, 74.0, 78.0, 78.0, 79.0, 84.0, 84.0, 85.0, 88.0]",22,13,9,0.4090909090909091,0.5909090909090909
161,2500847,"[20.0, 20.0, 23.0, 26.0, 27.0, 31.0, 34.0, 43.0, 42.0, 42.0, 44.0, 45.0, 45.0, 51.0, 54.0, 59.0, 64.0, 82.0, 84.0, 88.0]",20,9,11,0.55,0.45
162,2500848,"[2.0, 13.0, 15.0, 21.0, 25.0, 28.0, 34.0, 35.0, 44.0, 44.0, 46.0, 56.0, 59.0, 69.0, 70.0, 70.0, 70.0, 80.0]",18,8,10,0.5555555555555556,0.4444444444444444
163,2500849,"[1.0, 4.0, 31.0, 37.0, 40.0, 43.0, 43.0, 41.0, 45.0, 47.0, 53.0, 55.0, 56.0, 60.0, 66.0, 70.0, 72.0, 80.0, 82.0, 83.0, 84.0, 84.0]",22,14,8,0.36363636363636365,0.6363636363636364
164,2500850,"[7.0, 11.0, 15.0, 20.0, 23.0, 23.0, 26.0, 30.0, 38.0, 40.0, 41.0, 58.0, 64.0, 66.0, 68.0, 70.0, 74.0, 75.0, 76.0, 77.0, 78.0, 82.0, 84.0]",23,12,11,0.4782608695652174,0.5217391304347826
165,2500851,"[6.0, 7.0, 11.0, 22.0, 23.0, 37.0, 41.0, 43.0, 43.0, 49.0, 73.0, 80.0, 81.0, 84.0, 84.0, 88.0]",16,7,9,0.5625,0.4375
166,2500852,"[14.0, 15.0, 19.0, 20.0, 25.0, 25.0, 27.0, 27.0, 44.0, 54.0, 55.0, 56.0, 61.0, 63.0, 65.0, 71.0, 76.0, 79.0, 81.0, 83.0, 88.0]",21,12,9,0.42857142857142855,0.5714285714285714
167,2500853,"[2.0, 6.0, 11.0, 15.0, 16.0, 30.0, 30.0, 32.0, 34.0, 42.0, 42.0, 45.0, 46.0, 48.0, 55.0, 56.0, 60.0, 68.0, 69.0, 69.0, 71.0, 71.0, 71.0, 74.0, 77.0, 78.0, 85.0, 87.0]",28,17,11,0.39285714285714285,0.6071428571428571
168,2500854,"[7.0, 8.0, 15.0, 18.0, 28.0, 32.0, 32.0, 38.0, 42.0, 44.0, 45.0, 50.0, 67.0, 73.0, 78.0, 81.0, 82.0, 83.0, 85.0, 85.0, 87.0, 88.0]",22,12,10,0.45454545454545453,0.5454545454545454
169,2500855,"[23.0, 26.0, 29.0, 33.0, 36.0, 37.0, 46.0, 41.0, 46.0, 53.0, 54.0, 55.0, 63.0, 63.0, 66.0, 75.0, 78.0]",17,10,7,0.4117647058823529,0.5882352941176471
170,2500856,"[1.0, 9.0, 11.0, 19.0, 23.0, 25.0, 31.0, 44.0, 46.0, 47.0, 48.0, 49.0, 61.0, 70.0, 74.0, 75.0, 75.0, 81.0, 84.0]",19,11,8,0.42105263157894735,0.5789473684210527
171,2500857,"[4.0, 6.0, 12.0, 17.0, 19.0, 23.0, 32.0, 33.0, 34.0, 46.0, 44.0, 52.0, 53.0, 58.0, 63.0, 65.0, 70.0, 73.0, 73.0, 77.0, 81.0]",21,11,10,0.47619047619047616,0.5238095238095238
172,2500858,"[13.0, 13.0, 18.0, 24.0, 32.0, 37.0, 37.0, 45.0, 42.0, 42.0, 45.0, 45.0, 52.0, 59.0, 67.0, 75.0, 78.0, 78.0, 84.0, 84.0, 87.0, 88.0, 88.0]",23,14,9,0.391304347826087,0.6086956521739131
173,2500859,"[5.0, 6.0, 8.0, 20.0, 28.0, 30.0, 64.0, 67.0, 72.0, 74.0, 75.0, 79.0, 88.0]",13,7,6,0.46153846153846156,0.5384615384615384
174,2500860,"[5.0, 5.0, 10.0, 21.0, 29.0, 42.0, 42.0, 47.0, 49.0, 53.0, 53.0, 64.0, 79.0, 80.0]",14,7,7,0.5,0.5
175,2500861,"[4.0, 11.0, 20.0, 27.0, 29.0, 35.0, 38.0, 42.0, 44.0, 50.0, 52.0, 52.0, 53.0, 63.0, 66.0, 68.0, 76.0, 84.0, 86.0]",19,10,9,0.47368421052631576,0.5263157894736842
176,2500862,"[3.0, 4.0, 8.0, 9.0, 10.0, 13.0, 16.0, 20.0, 23.0, 26.0, 33.0, 34.0, 34.0, 35.0, 39.0, 41.0, 43.0, 43.0, 46.0, 41.0, 43.0, 47.0, 47.0, 62.0, 69.0, 71.0, 77.0, 79.0, 81.0, 82.0, 87.0, 87.0]",32,12,20,0.625,0.375
177,2500863,"[3.0, 3.0, 5.0, 7.0, 9.0, 11.0, 12.0, 17.0, 18.0, 24.0, 24.0, 31.0, 41.0, 46.0, 47.0, 47.0, 47.0, 55.0, 62.0, 63.0, 65.0, 76.0, 78.0, 78.0, 80.0, 80.0]",26,13,13,0.5,0.5
178,2500864,"[2.0, 7.0, 7.0, 8.0, 17.0, 30.0, 37.0, 39.0, 46.0, 49.0, 53.0, 55.0, 60.0, 66.0, 68.0, 81.0, 83.0]",17,9,8,0.47058823529411764,0.5294117647058824
179,2500865,"[2.0, 5.0, 10.0, 18.0, 18.0, 20.0, 27.0, 27.0, 32.0, 52.0, 53.0, 46.0, 50.0, 52.0, 58.0, 60.0, 61.0, 62.0, 64.0, 67.0, 70.0, 72.0, 72.0, 78.0, 82.0, 83.0, 85.0, 85.0]",28,19,9,0.32142857142857145,0.6785714285714286
180,2500866,"[3.0, 11.0, 15.0, 16.0, 20.0, 26.0, 35.0, 38.0, 44.0, 43.0, 48.0, 53.0, 53.0, 61.0, 62.0, 70.0, 77.0, 84.0, 85.0, 86.0, 86.0, 88.0]",22,12,10,0.45454545454545453,0.5454545454545454
181,2500867,"[1.0, 3.0, 4.0, 6.0, 7.0, 13.0, 18.0, 24.0, 26.0, 27.0, 28.0, 29.0, 32.0, 35.0, 35.0, 38.0, 40.0, 41.0, 42.0, 42.0, 44.0, 46.0, 41.0, 47.0, 60.0, 63.0, 64.0, 69.0, 70.0, 75.0, 76.0, 80.0, 86.0, 87.0]",34,12,22,0.6470588235294118,0.35294117647058826
182,2500868,"[2.0, 11.0, 25.0, 29.0, 29.0, 37.0, 40.0, 41.0, 54.0, 61.0, 61.0, 65.0, 70.0, 84.0, 86.0]",15,7,8,0.5333333333333333,0.4666666666666667
183,2500869,"[5.0, 13.0, 15.0, 16.0, 18.0, 30.0, 34.0, 35.0, 36.0, 37.0, 39.0, 40.0, 43.0, 43.0, 44.0, 49.0, 56.0, 57.0, 58.0, 61.0, 69.0, 71.0, 72.0, 84.0, 84.0, 84.0, 89.0]",27,12,15,0.5555555555555556,0.4444444444444444
184,2500870,"[13.0, 21.0, 28.0, 35.0, 36.0, 38.0, 43.0, 44.0, 45.0, 53.0, 61.0, 62.0, 77.0]",13,5,8,0.6153846153846154,0.38461538461538464
185,2500871,"[10.0, 14.0, 16.0, 18.0, 20.0, 22.0, 24.0, 28.0, 28.0, 31.0, 34.0, 39.0, 44.0, 45.0, 53.0, 59.0, 60.0, 68.0, 69.0, 69.0, 71.0, 73.0, 76.0, 78.0, 80.0, 80.0]",26,13,13,0.5,0.5
186,2500872,"[4.0, 8.0, 8.0, 12.0, 16.0, 17.0, 19.0, 21.0, 24.0, 25.0, 26.0, 28.0, 28.0, 28.0, 38.0, 39.0, 43.0, 50.0, 51.0, 52.0, 56.0, 62.0, 64.0, 77.0, 78.0, 88.0]",26,9,17,0.6538461538461539,0.34615384615384615
187,2500873,"[1.0, 2.0, 7.0, 9.0, 20.0, 20.0, 27.0, 40.0, 45.0, 46.0, 46.0, 49.0, 50.0, 67.0, 68.0, 76.0]",16,8,8,0.5,0.5
188,2500874,"[3.0, 5.0, 9.0, 14.0, 14.0, 20.0, 24.0, 27.0, 32.0, 35.0, 37.0, 38.0, 39.0, 46.0, 47.0, 50.0, 51.0, 56.0, 57.0, 63.0, 64.0, 70.0, 72.0, 76.0, 83.0]",25,12,13,0.52,0.48
189,2500875,"[5.0, 7.0, 10.0, 15.0, 19.0, 30.0, 32.0, 34.0, 35.0, 36.0, 44.0, 43.0, 46.0, 47.0, 52.0, 53.0, 53.0, 55.0, 64.0, 76.0, 76.0, 80.0, 80.0, 81.0, 86.0, 88.0]",26,14,12,0.46153846153846156,0.5384615384615384
190,2500876,"[1.0, 12.0, 13.0, 13.0, 15.0, 19.0, 24.0, 32.0, 42.0, 42.0, 43.0, 44.0, 44.0, 49.0, 52.0, 58.0, 58.0, 68.0, 69.0, 72.0, 77.0, 79.0, 80.0, 86.0]",24,11,13,0.5416666666666666,0.4583333333333333
191,2500877,"[0.0, 11.0, 14.0, 22.0, 24.0, 31.0, 34.0, 35.0, 36.0, 40.0, 47.0, 47.0, 41.0, 42.0, 42.0, 51.0, 56.0, 58.0, 70.0, 74.0, 75.0, 76.0, 83.0]",23,10,13,0.5652173913043478,0.43478260869565216
192,2500878,"[3.0, 18.0, 18.0, 19.0, 26.0, 28.0, 30.0, 31.0, 42.0, 42.0, 52.0, 53.0, 60.0, 64.0, 65.0, 65.0, 67.0, 68.0, 71.0, 72.0, 75.0, 78.0, 80.0, 82.0, 82.0, 87.0]",26,16,10,0.38461538461538464,0.6153846153846154
193,2500879,"[3.0, 5.0, 5.0, 9.0, 18.0, 23.0, 29.0, 34.0, 35.0, 35.0, 38.0, 42.0, 42.0, 43.0, 43.0, 44.0, 45.0, 47.0, 50.0, 54.0, 58.0, 61.0, 72.0]",23,7,16,0.6956521739130435,0.30434782608695654
194,2500880,"[11.0, 14.0, 26.0, 36.0, 38.0, 38.0, 40.0, 41.0, 42.0, 44.0, 43.0, 45.0, 51.0, 51.0, 57.0, 59.0, 66.0, 66.0, 71.0, 72.0, 78.0, 79.0, 82.0, 83.0, 84.0, 88.0, 88.0]",27,16,11,0.4074074074074074,0.5925925925925926
195,2500881,"[1.0, 7.0, 9.0, 12.0, 15.0, 19.0, 21.0, 26.0, 28.0, 41.0, 41.0, 50.0, 51.0, 55.0, 56.0, 57.0, 57.0, 60.0, 62.0, 63.0, 68.0, 73.0, 74.0, 80.0, 80.0, 84.0, 84.0, 85.0]",28,17,11,0.39285714285714285,0.6071428571428571
196,2500882,"[0.0, 4.0, 7.0, 10.0, 11.0, 15.0, 16.0, 18.0, 23.0, 28.0, 35.0, 41.0, 44.0, 42.0, 42.0, 49.0, 50.0, 54.0, 54.0, 61.0, 65.0, 71.0, 77.0, 84.0, 85.0, 87.0]",26,11,15,0.5769230769230769,0.4230769230769231
197,2500883,"[11.0, 19.0, 21.0, 32.0, 37.0, 39.0, 40.0, 41.0, 43.0, 44.0, 46.0, 47.0, 48.0, 51.0, 58.0, 60.0, 61.0, 64.0, 73.0, 80.0, 85.0, 86.0]",22,12,10,0.45454545454545453,0.5454545454545454
198,2500884,"[4.0, 5.0, 8.0, 14.0, 16.0, 18.0, 23.0, 31.0, 44.0, 46.0, 48.0, 49.0, 53.0, 56.0, 62.0, 64.0, 69.0, 70.0, 71.0, 78.0, 84.0, 86.0]",22,13,9,0.4090909090909091,0.5909090909090909
199,2500885,"[3.0, 12.0, 13.0, 14.0, 22.0, 24.0, 31.0, 45.0, 45.0, 51.0, 55.0, 58.0, 71.0, 72.0, 74.0, 82.0]",16,9,7,0.4375,0.5625
200,2500886,"[8.0, 13.0, 22.0, 23.0, 25.0, 25.0, 33.0, 36.0, 39.0, 39.0, 41.0, 43.0, 49.0, 53.0, 55.0, 59.0, 60.0, 65.0, 65.0, 66.0, 74.0, 79.0, 79.0, 80.0, 88.0]",25,13,12,0.48,0.52
201,2500887,"[0.0, 5.0, 16.0, 21.0, 32.0, 39.0, 45.0, 45.0, 46.0, 50.0, 51.0, 53.0, 54.0, 57.0, 65.0, 75.0, 80.0]",17,11,6,0.35294117647058826,0.6470588235294118
202,2500888,"[3.0, 19.0, 21.0, 27.0, 29.0, 32.0, 35.0, 35.0, 39.0, 42.0, 43.0, 44.0, 58.0, 61.0, 67.0, 71.0, 76.0, 88.0]",18,6,12,0.6666666666666666,0.3333333333333333
203,2500889,"[4.0, 10.0, 12.0, 17.0, 22.0, 25.0, 29.0, 30.0, 30.0, 32.0, 34.0, 37.0, 43.0, 45.0, 53.0, 56.0, 56.0, 57.0, 61.0, 62.0, 64.0, 69.0, 70.0, 88.0, 88.0]",25,12,13,0.52,0.48
204,2500890,"[2.0, 5.0, 14.0, 15.0, 18.0, 21.0, 22.0, 24.0, 33.0, 39.0, 40.0, 45.0, 48.0, 48.0, 49.0, 54.0, 58.0, 59.0, 62.0, 64.0, 66.0, 67.0, 73.0, 75.0, 76.0, 77.0, 79.0, 83.0, 83.0]",29,18,11,0.3793103448275862,0.6206896551724138
205,2500891,"[19.0, 30.0, 40.0, 46.0, 46.0, 49.0, 56.0, 63.0, 63.0, 68.0, 70.0, 73.0, 73.0, 78.0, 82.0, 88.0]",16,13,3,0.1875,0.8125
206,2500892,"[6.0, 9.0, 16.0, 18.0, 18.0, 19.0, 21.0, 21.0, 26.0, 26.0, 31.0, 44.0, 44.0, 47.0, 40.0, 41.0, 51.0, 51.0, 55.0, 56.0, 70.0, 72.0, 83.0, 86.0]",24,9,15,0.625,0.375
207,2500893,"[6.0, 8.0, 25.0, 26.0, 28.0, 32.0, 33.0, 42.0, 53.0, 56.0, 62.0, 87.0, 87.0]",13,5,8,0.6153846153846154,0.38461538461538464
208,2500894,"[0.0, 3.0, 14.0, 14.0, 18.0, 20.0, 27.0, 38.0, 39.0, 40.0, 43.0, 45.0, 46.0, 51.0, 54.0, 54.0, 55.0, 64.0, 68.0, 71.0, 72.0, 75.0, 76.0, 82.0, 84.0]",25,14,11,0.44,0.56
209,2500895,"[1.0, 3.0, 3.0, 7.0, 7.0, 9.0, 15.0, 16.0, 18.0, 19.0, 28.0, 32.0, 34.0, 34.0, 45.0, 42.0, 44.0, 50.0, 61.0, 74.0, 74.0, 87.0]",22,6,16,0.7272727272727273,0.2727272727272727
210,2500896,"[2.0, 19.0, 21.0, 23.0, 28.0, 32.0, 41.0, 43.0, 44.0, 69.0, 74.0, 78.0, 78.0, 85.0]",14,5,9,0.6428571428571429,0.35714285714285715
211,2500897,"[15.0, 27.0, 34.0, 43.0, 47.0, 55.0, 56.0, 57.0, 60.0, 66.0, 68.0, 68.0, 70.0, 74.0]",14,10,4,0.2857142857142857,0.7142857142857143
212,2500898,"[7.0, 9.0, 11.0, 16.0, 17.0, 39.0, 46.0, 48.0, 45.0, 50.0, 57.0, 57.0, 73.0, 77.0, 80.0, 87.0, 89.0]",17,11,6,0.35294117647058826,0.6470588235294118
213,2500899,"[0.0, 11.0, 19.0, 44.0, 46.0, 47.0, 47.0, 55.0, 55.0, 56.0, 62.0, 67.0, 75.0, 78.0, 84.0, 85.0]",16,12,4,0.25,0.75
214,2500900,"[4.0, 5.0, 21.0, 26.0, 29.0, 30.0, 35.0, 39.0, 44.0, 45.0, 42.0, 43.0, 53.0, 55.0, 57.0, 61.0, 62.0, 69.0, 69.0, 70.0, 72.0, 72.0, 72.0, 78.0, 83.0, 86.0, 90.0]",27,16,11,0.4074074074074074,0.5925925925925926
215,2500901,"[6.0, 11.0, 22.0, 26.0, 26.0, 33.0, 39.0, 40.0, 42.0, 44.0, 45.0, 47.0, 48.0, 58.0, 60.0, 68.0, 76.0, 87.0, 87.0]",19,9,10,0.5263157894736842,0.47368421052631576
216,2500902,"[1.0, 18.0, 19.0, 34.0, 40.0, 43.0, 42.0, 43.0, 43.0, 49.0, 71.0, 80.0, 82.0, 82.0, 84.0]",15,6,9,0.6,0.4
217,2500903,"[3.0, 14.0, 18.0, 22.0, 42.0, 43.0, 45.0, 57.0, 59.0, 63.0, 66.0, 66.0, 72.0, 76.0, 82.0, 82.0, 83.0]",17,11,6,0.35294117647058826,0.6470588235294118
218,2500904,"[4.0, 4.0, 4.0, 10.0, 28.0, 33.0, 39.0, 44.0, 44.0, 45.0, 44.0, 49.0, 53.0, 61.0, 62.0, 67.0, 68.0, 70.0, 78.0, 87.0]",20,10,10,0.5,0.5
219,2500905,"[4.0, 6.0, 26.0, 29.0, 44.0, 44.0, 57.0, 60.0, 71.0, 76.0, 83.0, 88.0]",12,6,6,0.5,0.5
220,2500906,"[1.0, 6.0, 6.0, 9.0, 11.0, 13.0, 22.0, 33.0, 34.0, 41.0, 42.0, 44.0, 52.0, 71.0, 78.0, 83.0]",16,4,12,0.75,0.25
221,2500907,"[5.0, 14.0, 21.0, 34.0, 43.0, 51.0, 53.0, 54.0, 63.0, 66.0, 72.0, 83.0]",12,7,5,0.4166666666666667,0.5833333333333334
222,2500908,"[23.0, 26.0, 26.0, 30.0, 33.0, 37.0, 37.0, 40.0, 43.0, 46.0, 49.0, 51.0, 51.0, 52.0, 56.0, 60.0, 62.0, 66.0, 75.0, 76.0, 86.0]",21,12,9,0.42857142857142855,0.5714285714285714
223,2500909,"[2.0, 8.0, 24.0, 40.0, 42.0, 42.0, 48.0, 52.0, 55.0, 65.0, 77.0, 78.0, 88.0]",13,7,6,0.46153846153846156,0.5384615384615384
224,2500910,"[4.0, 20.0, 21.0, 39.0, 41.0, 41.0, 43.0, 43.0, 47.0, 48.0, 55.0, 64.0, 66.0, 71.0, 72.0, 80.0, 82.0, 85.0, 85.0]",19,11,8,0.42105263157894735,0.5789473684210527
225,2500911,"[4.0, 6.0, 21.0, 21.0, 28.0, 34.0, 39.0, 43.0, 42.0, 46.0, 49.0, 53.0, 53.0, 53.0, 54.0, 54.0, 63.0, 66.0, 66.0, 68.0, 74.0, 78.0]",22,13,9,0.4090909090909091,0.5909090909090909
226,2500912,"[1.0, 10.0, 12.0, 16.0, 21.0, 21.0, 27.0, 31.0, 34.0, 35.0, 40.0, 41.0, 44.0, 45.0, 43.0, 44.0, 52.0, 54.0, 57.0, 64.0, 72.0, 77.0]",22,7,15,0.6818181818181818,0.3181818181818182
227,2500913,"[2.0, 9.0, 11.0, 13.0, 25.0, 32.0, 32.0, 36.0, 39.0, 44.0, 41.0, 44.0, 49.0, 54.0, 61.0, 61.0, 65.0, 75.0, 77.0, 80.0, 83.0, 85.0]",22,10,12,0.5454545454545454,0.45454545454545453
228,2500914,"[1.0, 1.0, 5.0, 11.0, 12.0, 25.0, 29.0, 30.0, 31.0, 35.0, 38.0, 45.0, 45.0, 41.0, 46.0, 46.0, 46.0, 65.0, 66.0, 72.0, 72.0, 75.0, 80.0, 82.0, 83.0]",25,13,12,0.48,0.52
229,2500915,"[4.0, 9.0, 9.0, 10.0, 14.0, 25.0, 40.0, 44.0, 58.0, 59.0, 61.0, 63.0, 67.0, 69.0, 72.0, 72.0, 73.0, 77.0, 85.0, 86.0]",20,12,8,0.4,0.6
230,2500916,"[14.0, 16.0, 19.0, 25.0, 29.0, 35.0, 37.0, 45.0, 48.0, 54.0, 56.0, 56.0, 60.0, 67.0, 68.0, 71.0, 71.0, 74.0, 79.0, 84.0]",20,13,7,0.35,0.65
231,2500917,"[1.0, 9.0, 16.0, 19.0, 24.0, 26.0, 30.0, 30.0, 32.0, 41.0, 45.0, 40.0, 42.0, 44.0, 47.0, 48.0, 49.0, 52.0, 54.0, 56.0, 58.0, 62.0, 67.0, 68.0, 74.0, 80.0, 82.0, 82.0, 87.0]",29,16,13,0.4482758620689655,0.5517241379310345
232,2500918,"[9.0, 18.0, 18.0, 24.0, 26.0, 28.0, 29.0, 29.0, 30.0, 35.0, 37.0, 38.0, 43.0, 43.0, 45.0, 49.0, 52.0, 53.0, 55.0, 76.0, 81.0, 82.0, 85.0, 86.0, 86.0]",25,11,14,0.56,0.44
233,2500919,"[5.0, 8.0, 13.0, 20.0, 23.0, 24.0, 25.0, 26.0, 27.0, 32.0, 34.0, 43.0, 44.0, 44.0, 44.0, 48.0, 50.0, 54.0, 60.0, 64.0, 66.0, 66.0, 68.0, 68.0, 70.0, 73.0, 76.0, 79.0, 83.0, 85.0]",30,15,15,0.5,0.5
234,2500920,"[1.0, 3.0, 7.0, 11.0, 22.0, 27.0, 31.0, 36.0, 48.0, 46.0, 48.0, 51.0, 59.0, 61.0, 63.0, 67.0, 69.0, 72.0, 80.0, 80.0, 83.0, 85.0]",22,14,8,0.36363636363636365,0.6363636363636364
235,2500921,"[3.0, 3.0, 11.0, 12.0, 14.0, 27.0, 42.0, 43.0, 52.0, 59.0, 64.0, 65.0, 81.0, 84.0]",14,6,8,0.5714285714285714,0.42857142857142855
236,2500922,"[1.0, 2.0, 5.0, 5.0, 6.0, 8.0, 21.0, 26.0, 30.0, 34.0, 51.0, 61.0, 62.0, 67.0, 77.0, 81.0, 85.0]",17,7,10,0.5882352941176471,0.4117647058823529
237,2500923,"[6.0, 6.0, 7.0, 9.0, 13.0, 17.0, 20.0, 29.0, 34.0, 36.0, 39.0, 44.0, 60.0, 60.0, 60.0, 62.0, 69.0, 72.0, 76.0, 77.0, 86.0]",21,9,12,0.5714285714285714,0.42857142857142855
238,2500924,"[2.0, 2.0, 7.0, 12.0, 21.0, 40.0, 45.0, 47.0, 57.0, 67.0, 76.0, 79.0, 82.0]",13,7,6,0.46153846153846156,0.5384615384615384
239,2500925,"[8.0, 9.0, 30.0, 34.0, 41.0, 42.0, 43.0, 44.0, 44.0, 46.0, 58.0, 66.0, 68.0, 74.0, 76.0, 80.0]",16,7,9,0.5625,0.4375
240,2500926,"[6.0, 14.0, 16.0, 20.0, 22.0, 27.0, 29.0, 30.0, 32.0, 35.0, 44.0, 44.0, 46.0, 48.0, 50.0, 53.0, 60.0, 65.0, 78.0, 81.0]",20,8,12,0.6,0.4
241,2500927,"[10.0, 15.0, 18.0, 21.0, 31.0, 37.0, 39.0, 41.0, 42.0, 44.0, 48.0, 54.0, 55.0, 55.0, 62.0, 63.0, 66.0, 66.0, 69.0, 70.0, 72.0, 73.0, 75.0, 78.0, 85.0, 88.0, 90.0, 90.0]",28,18,10,0.35714285714285715,0.6428571428571429
242,2500928,"[5.0, 5.0, 19.0, 23.0, 31.0, 35.0, 37.0, 42.0, 45.0, 45.0, 48.0, 49.0, 50.0, 51.0, 55.0, 55.0, 59.0, 62.0, 64.0, 68.0, 77.0, 78.0]",22,14,8,0.36363636363636365,0.6363636363636364
243,2500929,"[3.0, 8.0, 10.0, 14.0, 31.0, 35.0, 36.0, 41.0, 45.0, 69.0, 69.0, 74.0, 76.0, 79.0, 83.0, 87.0]",16,8,8,0.5,0.5
244,2500930,"[5.0, 11.0, 12.0, 14.0, 17.0, 19.0, 36.0, 37.0, 37.0, 38.0, 40.0, 42.0, 41.0, 41.0, 45.0, 49.0, 51.0, 55.0, 64.0, 68.0, 69.0, 75.0, 81.0, 87.0, 87.0]",25,11,14,0.56,0.44
245,2500931,"[5.0, 7.0, 15.0, 20.0, 23.0, 32.0, 36.0, 39.0, 41.0, 42.0, 43.0, 45.0, 45.0, 46.0, 45.0, 46.0, 53.0, 58.0, 60.0, 66.0, 71.0, 73.0, 76.0, 78.0, 87.0]",25,14,11,0.44,0.56
246,2500932,"[10.0, 12.0, 16.0, 18.0, 30.0, 31.0, 36.0, 38.0, 42.0, 45.0, 52.0, 53.0, 60.0, 61.0, 62.0, 64.0, 65.0, 65.0, 68.0, 75.0, 77.0, 79.0, 84.0]",23,14,9,0.391304347826087,0.6086956521739131
247,2500933,"[3.0, 5.0, 7.0, 9.0, 11.0, 20.0, 25.0, 25.0, 40.0, 43.0, 56.0, 70.0, 71.0, 71.0, 74.0, 81.0, 81.0, 84.0, 86.0, 86.0]",20,10,10,0.5,0.5
248,2500934,"[5.0, 21.0, 29.0, 33.0, 40.0, 40.0, 41.0, 40.0, 40.0, 45.0, 45.0, 55.0, 56.0, 56.0, 56.0, 58.0, 59.0, 61.0, 64.0, 66.0, 77.0, 81.0, 82.0, 86.0, 88.0]",25,16,9,0.36,0.64
249,2500935,"[4.0, 8.0, 9.0, 11.0, 13.0, 17.0, 26.0, 28.0, 33.0, 36.0, 38.0, 40.0, 42.0, 62.0, 65.0, 72.0, 72.0, 74.0, 77.0, 84.0]",20,7,13,0.65,0.35
250,2500936,"[3.0, 4.0, 18.0, 32.0, 35.0, 41.0, 43.0, 44.0, 61.0, 62.0, 72.0, 77.0, 78.0, 80.0, 80.0, 84.0]",16,8,8,0.5,0.5
251,2500937,"[5.0, 5.0, 9.0, 15.0, 17.0, 24.0, 27.0, 29.0, 31.0, 31.0, 32.0, 34.0, 38.0, 39.0, 45.0, 55.0, 56.0, 59.0, 63.0, 68.0, 70.0, 73.0, 77.0, 78.0, 79.0, 83.0]",26,12,14,0.5384615384615384,0.46153846153846156
252,2500938,"[3.0, 6.0, 9.0, 17.0, 20.0, 29.0, 32.0, 33.0, 38.0, 43.0, 44.0, 48.0, 48.0, 49.0, 56.0, 57.0, 63.0, 64.0, 70.0, 71.0, 78.0, 86.0, 90.0]",23,12,11,0.4782608695652174,0.5217391304347826
253,2500939,"[13.0, 17.0, 19.0, 21.0, 37.0, 39.0, 43.0, 47.0, 48.0, 50.0, 53.0, 54.0, 59.0, 60.0, 62.0, 63.0, 64.0, 65.0, 75.0, 76.0, 82.0, 83.0, 86.0]",23,16,7,0.30434782608695654,0.6956521739130435
254,2500940,"[8.0, 8.0, 22.0, 22.0, 27.0, 29.0, 29.0, 34.0, 41.0, 44.0, 53.0, 78.0, 87.0, 88.0]",14,4,10,0.7142857142857143,0.2857142857142857
255,2500941,"[2.0, 5.0, 12.0, 13.0, 14.0, 19.0, 20.0, 24.0, 29.0, 48.0, 50.0, 57.0, 62.0, 78.0, 82.0, 82.0, 87.0]",17,8,9,0.5294117647058824,0.47058823529411764
256,2500942,"[5.0, 9.0, 11.0, 32.0, 45.0, 51.0, 54.0, 55.0, 68.0, 68.0, 69.0, 71.0, 73.0, 81.0, 82.0, 87.0, 88.0, 89.0]",18,14,4,0.2222222222222222,0.7777777777777778
257,2500943,"[4.0, 5.0, 14.0, 22.0, 24.0, 28.0, 36.0, 40.0, 41.0, 42.0, 57.0, 59.0, 62.0, 64.0, 64.0, 78.0, 85.0, 85.0, 89.0]",19,9,10,0.5263157894736842,0.47368421052631576
258,2500944,"[1.0, 5.0, 7.0, 8.0, 10.0, 17.0, 19.0, 21.0, 21.0, 23.0, 27.0, 28.0, 29.0, 31.0, 39.0, 42.0, 57.0, 57.0, 59.0, 61.0, 66.0, 67.0, 73.0, 74.0, 78.0, 81.0, 83.0]",27,11,16,0.5925925925925926,0.4074074074074074
259,2500945,"[6.0, 9.0, 9.0, 9.0, 12.0, 15.0, 17.0, 28.0, 29.0, 42.0, 47.0, 47.0, 48.0, 42.0, 47.0, 47.0, 55.0, 57.0, 58.0, 59.0, 61.0, 63.0, 69.0, 81.0, 82.0, 84.0, 86.0, 90.0]",28,17,11,0.39285714285714285,0.6071428571428571
260,2500946,"[6.0, 10.0, 11.0, 11.0, 14.0, 14.0, 14.0, 16.0, 26.0, 33.0, 43.0, 47.0, 50.0, 52.0, 53.0, 61.0, 68.0, 69.0, 74.0, 75.0, 76.0, 84.0, 85.0, 86.0]",24,13,11,0.4583333333333333,0.5416666666666666
261,2500947,"[3.0, 6.0, 7.0, 8.0, 8.0, 13.0, 29.0, 29.0, 39.0, 43.0, 40.0, 41.0, 48.0, 48.0, 59.0, 67.0, 70.0, 73.0, 75.0, 76.0, 77.0, 79.0]",22,10,12,0.5454545454545454,0.45454545454545453
262,2500948,"[4.0, 8.0, 11.0, 19.0, 22.0, 23.0, 25.0, 28.0, 30.0, 43.0, 42.0, 42.0, 44.0, 47.0, 51.0, 52.0, 55.0, 80.0, 80.0, 80.0, 83.0]",21,8,13,0.6190476190476191,0.38095238095238093
263,2500949,"[5.0, 7.0, 8.0, 10.0, 18.0, 21.0, 21.0, 21.0, 23.0, 27.0, 35.0, 37.0, 38.0, 44.0, 46.0, 49.0, 51.0, 56.0, 62.0, 68.0, 71.0, 72.0, 82.0, 84.0, 84.0]",25,11,14,0.56,0.44
264,2500950,"[19.0, 25.0, 25.0, 27.0, 39.0, 46.0, 48.0, 49.0, 54.0, 55.0, 69.0, 69.0, 70.0, 76.0, 84.0, 88.0]",16,11,5,0.3125,0.6875
265,2500951,"[18.0, 23.0, 25.0, 28.0, 32.0, 34.0, 35.0, 45.0, 46.0, 44.0, 57.0, 57.0, 57.0, 57.0, 57.0, 57.0, 65.0, 66.0, 67.0, 72.0, 78.0, 83.0, 85.0, 86.0, 86.0, 88.0, 88.0, 88.0, 89.0]",29,21,8,0.27586206896551724,0.7241379310344828
266,2500952,"[2.0, 8.0, 10.0, 15.0, 24.0, 25.0, 27.0, 36.0, 39.0, 40.0, 44.0, 45.0, 42.0, 49.0, 53.0, 58.0, 58.0, 62.0, 76.0, 78.0, 83.0, 86.0, 86.0, 88.0]",24,12,12,0.5,0.5
267,2500953,"[4.0, 19.0, 36.0, 41.0, 42.0, 44.0, 53.0, 58.0, 63.0, 65.0, 66.0, 68.0, 81.0, 84.0, 85.0]",15,9,6,0.4,0.6
268,2500954,"[16.0, 24.0, 30.0, 45.0, 41.0, 45.0, 46.0, 56.0, 60.0, 63.0, 68.0, 74.0, 75.0, 79.0, 80.0, 82.0, 82.0]",17,13,4,0.23529411764705882,0.7647058823529411
269,2500955,"[4.0, 7.0, 10.0, 24.0, 31.0, 34.0, 36.0, 41.0, 41.0, 48.0, 59.0, 67.0, 67.0, 79.0, 81.0]",15,6,9,0.6,0.4
270,2500956,"[0.0, 2.0, 12.0, 15.0, 17.0, 18.0, 30.0, 31.0, 31.0, 34.0, 40.0, 40.0, 45.0, 42.0, 46.0, 52.0, 57.0, 63.0, 69.0, 70.0, 72.0, 76.0, 79.0, 79.0, 80.0, 84.0]",26,13,13,0.5,0.5
271,2500957,"[1.0, 7.0, 12.0, 21.0, 23.0, 25.0, 30.0, 32.0, 34.0, 35.0, 37.0, 40.0, 44.0, 43.0, 46.0, 59.0, 69.0, 74.0, 81.0, 81.0, 83.0, 83.0, 88.0]",23,9,14,0.6086956521739131,0.391304347826087
272,2500958,"[11.0, 17.0, 18.0, 22.0, 24.0, 30.0, 41.0, 43.0, 72.0, 73.0, 76.0, 77.0, 81.0, 84.0]",14,6,8,0.5714285714285714,0.42857142857142855
273,2500959,"[3.0, 10.0, 10.0, 11.0, 22.0, 24.0, 25.0, 28.0, 28.0, 29.0, 32.0, 34.0, 43.0, 51.0, 52.0, 57.0, 57.0, 58.0, 59.0, 66.0, 69.0, 74.0, 74.0, 77.0, 82.0, 83.0, 89.0, 89.0, 89.0]",29,16,13,0.4482758620689655,0.5517241379310345
274,2500960,"[2.0, 9.0, 27.0, 29.0, 30.0, 31.0, 40.0, 43.0, 42.0, 43.0, 46.0, 54.0, 57.0, 60.0, 62.0, 67.0, 68.0, 68.0, 74.0, 77.0, 79.0, 80.0, 81.0, 84.0, 84.0, 85.0, 87.0]",27,17,10,0.37037037037037035,0.6296296296296297
275,2500961,"[6.0, 6.0, 7.0, 15.0, 26.0, 32.0, 34.0, 37.0, 40.0, 40.0, 44.0, 49.0, 51.0, 53.0, 57.0, 63.0, 70.0, 73.0, 74.0, 75.0, 76.0, 79.0, 89.0]",23,12,11,0.4782608695652174,0.5217391304347826
276,2500962,"[7.0, 11.0, 18.0, 31.0, 32.0, 35.0, 36.0, 38.0, 38.0, 42.0, 43.0, 49.0, 50.0, 50.0, 50.0, 52.0, 64.0, 70.0, 76.0, 76.0, 77.0, 77.0, 78.0, 84.0, 85.0, 88.0]",26,15,11,0.4230769230769231,0.5769230769230769
277,2500963,"[4.0, 7.0, 15.0, 15.0, 18.0, 22.0, 29.0, 30.0, 31.0, 38.0, 38.0, 38.0, 46.0, 48.0, 51.0, 52.0, 53.0, 54.0, 54.0, 55.0, 57.0, 63.0, 72.0, 74.0, 77.0, 77.0, 84.0, 87.0, 87.0]",29,17,12,0.41379310344827586,0.5862068965517241
278,2500964,"[5.0, 7.0, 11.0, 21.0, 24.0, 27.0, 30.0, 32.0, 46.0, 46.0, 41.0, 44.0, 49.0, 56.0, 60.0, 62.0, 65.0, 71.0, 72.0, 76.0, 85.0]",21,11,10,0.47619047619047616,0.5238095238095238
279,2500965,"[3.0, 7.0, 17.0, 25.0, 27.0, 31.0, 31.0, 37.0, 39.0, 42.0, 46.0, 41.0, 46.0, 56.0, 59.0, 59.0, 62.0, 65.0, 71.0, 77.0, 80.0, 81.0, 82.0, 84.0, 87.0, 88.0, 88.0]",27,16,11,0.4074074074074074,0.5925925925925926
280,2500966,"[2.0, 14.0, 18.0, 26.0, 27.0, 29.0, 30.0, 36.0, 42.0, 42.0, 44.0, 49.0, 56.0, 60.0, 68.0, 69.0, 75.0, 77.0, 80.0]",19,8,11,0.5789473684210527,0.42105263157894735
281,2500967,"[2.0, 3.0, 6.0, 11.0, 21.0, 28.0, 37.0, 38.0, 38.0, 42.0, 45.0, 46.0, 46.0, 45.0, 60.0, 63.0, 65.0, 68.0, 72.0, 74.0, 75.0]",21,11,10,0.47619047619047616,0.5238095238095238
282,2500968,"[13.0, 15.0, 20.0, 21.0, 23.0, 25.0, 29.0, 30.0, 34.0, 40.0, 41.0, 41.0, 42.0, 48.0, 53.0, 53.0, 58.0, 58.0, 60.0, 63.0, 66.0, 68.0, 71.0, 73.0, 75.0, 81.0, 87.0]",27,14,13,0.48148148148148145,0.5185185185185185
283,2500969,"[2.0, 3.0, 6.0, 6.0, 15.0, 41.0, 45.0, 58.0, 61.0, 62.0, 64.0, 73.0, 74.0, 77.0, 78.0, 80.0, 89.0]",17,11,6,0.35294117647058826,0.6470588235294118
284,2500970,"[5.0, 26.0, 26.0, 34.0, 35.0, 39.0, 40.0, 42.0, 44.0, 53.0, 53.0, 57.0, 58.0, 60.0, 64.0, 70.0, 74.0, 78.0, 80.0, 81.0, 82.0, 85.0, 85.0, 86.0]",24,15,9,0.375,0.625
285,2500971,"[10.0, 18.0, 20.0, 20.0, 21.0, 30.0, 34.0, 42.0, 44.0, 45.0, 46.0, 41.0, 49.0, 52.0, 55.0, 57.0, 62.0, 66.0, 66.0, 72.0, 74.0, 76.0, 81.0, 85.0, 86.0, 88.0]",26,16,10,0.38461538461538464,0.6153846153846154
286,2500972,"[5.0, 5.0, 11.0, 11.0, 16.0, 20.0, 26.0, 28.0, 33.0, 42.0, 46.0, 45.0, 51.0, 53.0, 59.0, 60.0, 63.0, 69.0, 70.0, 76.0, 83.0, 83.0]",22,12,10,0.45454545454545453,0.5454545454545454
287,2500973,"[9.0, 10.0, 10.0, 18.0, 22.0, 22.0, 23.0, 24.0, 35.0, 37.0, 43.0, 43.0, 43.0, 47.0, 49.0, 53.0, 55.0, 58.0, 67.0, 77.0, 78.0, 79.0, 81.0]",23,10,13,0.5652173913043478,0.43478260869565216
288,2500974,"[1.0, 4.0, 4.0, 9.0, 12.0, 13.0, 13.0, 15.0, 17.0, 17.0, 19.0, 19.0, 21.0, 27.0, 33.0, 35.0, 38.0, 39.0, 41.0, 44.0, 44.0, 42.0, 48.0, 51.0, 52.0, 52.0, 54.0, 58.0, 63.0, 63.0, 68.0, 71.0, 71.0, 74.0, 77.0, 78.0, 79.0, 87.0, 91.0]",39,17,22,0.5641025641025641,0.4358974358974359
289,2500975,"[5.0, 9.0, 14.0, 14.0, 15.0, 18.0, 19.0, 29.0, 33.0, 41.0, 45.0, 42.0, 47.0, 52.0, 57.0, 58.0, 58.0, 59.0, 62.0, 64.0, 66.0, 69.0, 69.0, 69.0, 70.0, 72.0, 73.0, 78.0, 82.0, 85.0, 88.0, 90.0]",32,21,11,0.34375,0.65625
290,2500976,"[2.0, 9.0, 9.0, 29.0, 34.0, 44.0, 51.0, 53.0, 60.0, 61.0, 67.0, 67.0, 74.0, 82.0]",14,8,6,0.42857142857142855,0.5714285714285714
291,2500977,"[0.0, 5.0, 7.0, 10.0, 16.0, 25.0, 25.0, 29.0, 30.0, 30.0, 36.0, 41.0, 43.0, 41.0, 50.0, 63.0, 65.0, 68.0, 77.0, 78.0]",20,6,14,0.7,0.3
292,2500978,"[10.0, 31.0, 43.0, 43.0, 45.0, 48.0, 49.0, 51.0, 51.0, 54.0, 76.0, 79.0, 80.0, 88.0]",14,10,4,0.2857142857142857,0.7142857142857143
293,2500979,"[1.0, 12.0, 15.0, 15.0, 16.0, 20.0, 27.0, 28.0, 31.0, 39.0, 41.0, 47.0, 48.0, 52.0, 64.0, 65.0, 70.0, 79.0, 84.0, 86.0, 86.0]",21,10,11,0.5238095238095238,0.47619047619047616
294,2500980,"[1.0, 9.0, 11.0, 16.0, 18.0, 22.0, 23.0, 33.0, 33.0, 36.0, 36.0, 62.0, 64.0, 66.0, 67.0, 68.0, 69.0, 76.0, 77.0, 79.0, 83.0, 84.0, 86.0]",23,12,11,0.4782608695652174,0.5217391304347826
295,2500981,"[4.0, 9.0, 12.0, 16.0, 21.0, 24.0, 26.0, 37.0, 43.0, 43.0, 42.0, 47.0, 55.0, 57.0, 71.0, 77.0, 81.0, 84.0, 84.0, 86.0]",20,9,11,0.55,0.45
296,2500982,"[3.0, 10.0, 12.0, 14.0, 18.0, 18.0, 19.0, 20.0, 25.0, 26.0, 31.0, 38.0, 38.0, 43.0, 45.0, 54.0, 61.0, 64.0, 72.0, 73.0, 73.0, 81.0, 85.0, 85.0, 86.0]",25,11,14,0.56,0.44
297,2500983,"[5.0, 13.0, 13.0, 16.0, 17.0, 19.0, 20.0, 25.0, 33.0, 37.0, 41.0, 44.0, 45.0, 46.0, 47.0, 49.0, 54.0, 56.0, 56.0, 58.0, 61.0, 64.0, 67.0, 70.0, 71.0, 73.0, 77.0, 82.0, 82.0, 83.0, 85.0, 86.0]",32,20,12,0.375,0.625
298,2500984,"[2.0, 3.0, 8.0, 9.0, 13.0, 16.0, 18.0, 22.0, 23.0, 29.0, 40.0, 43.0, 56.0, 59.0, 63.0, 67.0, 67.0, 74.0, 77.0, 78.0, 84.0, 85.0, 87.0, 87.0]",24,12,12,0.5,0.5
299,2500985,"[15.0, 17.0, 20.0, 26.0, 28.0, 31.0, 32.0, 37.0, 40.0, 44.0, 47.0, 48.0, 64.0, 65.0, 69.0, 76.0, 83.0, 85.0, 86.0, 86.0, 89.0]",21,11,10,0.47619047619047616,0.5238095238095238
300,2500986,"[11.0, 19.0, 21.0, 23.0, 45.0, 46.0, 47.0, 47.0, 48.0, 48.0, 52.0, 54.0, 59.0, 72.0, 82.0, 86.0]",16,12,4,0.25,0.75
301,2500987,"[20.0, 26.0, 28.0, 29.0, 35.0, 41.0, 42.0, 46.0, 47.0, 42.0, 44.0, 49.0, 58.0, 59.0, 64.0, 68.0, 81.0, 82.0]",18,9,9,0.5,0.5
302,2500988,"[16.0, 18.0, 25.0, 26.0, 26.0, 33.0, 33.0, 36.0, 41.0, 45.0, 46.0, 47.0, 54.0, 54.0, 66.0, 68.0, 70.0, 71.0, 71.0, 75.0, 76.0, 85.0]",22,13,9,0.4090909090909091,0.5909090909090909
303,2500989,"[5.0, 12.0, 14.0, 15.0, 24.0, 27.0, 32.0, 40.0, 43.0, 45.0, 41.0, 46.0, 48.0, 49.0, 50.0, 51.0, 54.0, 60.0, 64.0, 65.0, 65.0, 69.0, 73.0, 76.0, 87.0]",25,15,10,0.4,0.6
304,2500990,"[7.0, 7.0, 7.0, 13.0, 14.0, 17.0, 18.0, 19.0, 22.0, 27.0, 29.0, 38.0, 40.0, 46.0, 46.0, 43.0, 44.0, 52.0, 53.0, 54.0, 57.0, 59.0, 69.0, 70.0, 71.0, 74.0, 74.0, 84.0, 86.0, 87.0]",30,15,15,0.5,0.5
305,2500991,"[4.0, 4.0, 4.0, 4.0, 9.0, 10.0, 13.0, 13.0, 17.0, 17.0, 23.0, 31.0, 33.0, 34.0, 34.0, 34.0, 42.0, 41.0, 43.0, 45.0, 47.0, 48.0, 53.0, 53.0, 57.0, 64.0, 66.0, 66.0, 71.0, 77.0, 78.0, 80.0, 80.0, 83.0]",34,15,19,0.5588235294117647,0.4411764705882353
306,2500992,"[6.0, 8.0, 9.0, 11.0, 25.0, 27.0, 28.0, 35.0, 36.0, 44.0, 46.0, 47.0, 49.0, 49.0, 50.0, 56.0, 57.0, 58.0, 60.0, 65.0, 65.0, 66.0, 67.0, 70.0, 76.0, 78.0, 78.0, 79.0, 82.0, 83.0, 84.0, 86.0]",32,22,10,0.3125,0.6875
307,2500993,"[5.0, 15.0, 16.0, 18.0, 19.0, 24.0, 25.0, 26.0, 29.0, 31.0, 34.0, 36.0, 36.0, 42.0, 43.0, 45.0, 55.0, 56.0, 60.0, 66.0, 70.0, 71.0, 74.0, 78.0, 83.0, 86.0]",26,11,15,0.5769230769230769,0.4230769230769231
308,2500994,"[5.0, 6.0, 9.0, 12.0, 17.0, 17.0, 34.0, 34.0, 36.0, 42.0, 45.0, 40.0, 48.0, 51.0, 53.0, 56.0, 61.0, 63.0, 72.0, 74.0, 78.0, 80.0, 81.0, 82.0, 85.0, 89.0]",26,15,11,0.4230769230769231,0.5769230769230769
309,2500995,"[4.0, 5.0, 15.0, 16.0, 20.0, 23.0, 27.0, 44.0, 41.0, 46.0, 47.0, 48.0, 51.0, 55.0, 56.0, 60.0, 65.0, 66.0, 70.0, 78.0, 79.0, 80.0, 87.0]",23,14,9,0.391304347826087,0.6086956521739131
310,2500996,"[0.0, 20.0, 22.0, 29.0, 29.0, 30.0, 31.0, 43.0, 47.0, 50.0, 54.0, 56.0, 62.0, 62.0, 68.0, 69.0, 70.0, 74.0, 74.0, 81.0, 81.0, 82.0]",22,14,8,0.36363636363636365,0.6363636363636364
311,2500997,"[6.0, 23.0, 26.0, 32.0, 45.0, 42.0, 54.0, 55.0, 60.0, 74.0, 82.0]",11,6,5,0.45454545454545453,0.5454545454545454
312,2500998,"[11.0, 13.0, 15.0, 17.0, 26.0, 31.0, 36.0, 37.0, 42.0, 44.0, 47.0, 48.0, 65.0, 76.0, 77.0, 78.0, 79.0, 79.0, 87.0]",19,9,10,0.5263157894736842,0.47368421052631576
313,2500999,"[22.0, 23.0, 28.0, 37.0, 37.0, 38.0, 41.0, 46.0, 42.0, 50.0, 51.0, 64.0, 68.0, 70.0, 73.0, 73.0, 73.0, 77.0, 78.0, 81.0, 82.0, 85.0, 87.0]",23,15,8,0.34782608695652173,0.6521739130434783
314,2501000,"[2.0, 8.0, 21.0, 28.0, 35.0, 42.0, 44.0, 45.0, 50.0, 51.0, 61.0, 62.0, 67.0, 68.0, 72.0, 80.0, 84.0]",17,10,7,0.4117647058823529,0.5882352941176471
315,2501001,"[0.0, 1.0, 6.0, 6.0, 15.0, 20.0, 30.0, 44.0, 41.0, 50.0, 52.0, 59.0, 62.0, 64.0, 66.0, 69.0, 70.0, 74.0, 75.0, 80.0, 80.0, 85.0]",22,13,9,0.4090909090909091,0.5909090909090909
316,2501002,"[20.0, 21.0, 31.0, 35.0, 41.0, 44.0, 47.0, 71.0, 72.0, 85.0, 88.0]",11,5,6,0.5454545454545454,0.45454545454545453
317,2501003,"[5.0, 16.0, 19.0, 26.0, 36.0, 36.0, 38.0, 39.0, 44.0, 41.0, 45.0, 45.0, 48.0, 51.0, 52.0, 54.0, 56.0, 65.0, 74.0]",19,9,10,0.5263157894736842,0.47368421052631576
318,2501004,"[5.0, 13.0, 16.0, 21.0, 23.0, 35.0, 39.0, 44.0, 45.0, 42.0, 43.0, 47.0, 51.0, 56.0, 62.0, 68.0, 70.0, 73.0, 77.0, 86.0]",20,10,10,0.5,0.5
319,2501005,"[9.0, 9.0, 11.0, 12.0, 28.0, 34.0, 34.0, 37.0, 38.0, 40.0, 41.0, 42.0, 49.0, 55.0, 55.0, 57.0, 62.0, 63.0, 63.0, 67.0, 68.0, 69.0, 82.0, 89.0]",24,12,12,0.5,0.5
320,2501006,"[8.0, 11.0, 11.0, 13.0, 16.0, 17.0, 25.0, 27.0, 32.0, 33.0, 36.0, 48.0, 51.0, 57.0, 61.0, 62.0, 64.0, 67.0, 68.0, 76.0, 78.0, 84.0]",22,11,11,0.5,0.5
321,2501007,"[14.0, 33.0, 33.0, 40.0, 47.0, 49.0, 56.0, 64.0, 67.0, 69.0, 75.0, 80.0]",12,8,4,0.3333333333333333,0.6666666666666666
322,2501008,"[20.0, 22.0, 34.0, 44.0, 46.0, 47.0, 47.0, 47.0, 50.0, 52.0, 88.0, 88.0, 90.0]",13,9,4,0.3076923076923077,0.6923076923076923
323,2501009,"[2.0, 2.0, 3.0, 4.0, 15.0, 18.0, 18.0, 19.0, 30.0, 45.0, 45.0, 50.0, 52.0, 60.0, 61.0, 64.0, 65.0, 65.0, 66.0, 66.0, 68.0, 71.0, 74.0, 76.0, 77.0, 79.0, 81.0, 84.0, 88.0]",29,20,9,0.3103448275862069,0.6896551724137931
324,2501010,"[8.0, 17.0, 23.0, 28.0, 30.0, 37.0, 46.0, 42.0, 44.0, 56.0, 59.0, 61.0, 63.0, 64.0, 68.0, 70.0, 71.0, 72.0, 74.0, 79.0, 79.0, 82.0, 82.0, 83.0, 89.0]",25,17,8,0.32,0.68
325,2501011,"[4.0, 22.0, 24.0, 25.0, 33.0, 33.0, 36.0, 37.0, 39.0, 39.0, 41.0, 42.0, 42.0, 46.0, 49.0, 56.0, 59.0, 60.0, 63.0, 75.0, 83.0, 83.0, 84.0, 85.0, 88.0]",25,12,13,0.52,0.48
326,2501012,"[9.0, 13.0, 14.0, 16.0, 19.0, 25.0, 26.0, 27.0, 29.0, 38.0, 44.0, 44.0, 46.0, 51.0, 52.0, 55.0, 62.0, 67.0, 69.0, 79.0, 79.0, 81.0]",22,10,12,0.5454545454545454,0.45454545454545453
327,2501013,"[3.0, 13.0, 16.0, 17.0, 21.0, 25.0, 26.0, 46.0, 49.0, 52.0, 60.0, 64.0, 67.0, 72.0, 80.0, 84.0, 86.0]",17,10,7,0.4117647058823529,0.5882352941176471
328,2501014,"[1.0, 4.0, 27.0, 28.0, 31.0, 33.0, 39.0, 44.0, 43.0, 50.0, 56.0, 63.0, 70.0, 71.0, 73.0, 77.0, 81.0, 82.0, 84.0, 87.0]",20,11,9,0.45,0.55
329,2501015,"[1.0, 2.0, 3.0, 6.0, 10.0, 13.0, 20.0, 20.0, 24.0, 35.0, 42.0, 43.0, 45.0, 43.0, 43.0, 56.0, 56.0, 56.0, 58.0, 64.0, 67.0, 69.0, 71.0, 71.0, 73.0, 75.0, 80.0, 83.0, 89.0, 89.0]",30,16,14,0.4666666666666667,0.5333333333333333
330,2501016,"[2.0, 6.0, 14.0, 22.0, 27.0, 42.0, 45.0, 41.0, 57.0, 58.0, 60.0, 67.0, 70.0, 70.0, 73.0, 73.0, 74.0, 77.0, 79.0, 80.0, 87.0, 89.0]",22,15,7,0.3181818181818182,0.6818181818181818
331,2501017,"[2.0, 7.0, 10.0, 12.0, 18.0, 19.0, 19.0, 22.0, 24.0, 26.0, 29.0, 30.0, 42.0, 43.0, 45.0, 44.0, 45.0, 46.0, 52.0, 54.0, 56.0, 58.0, 58.0, 68.0, 71.0, 73.0, 76.0, 78.0, 78.0, 80.0, 88.0]",31,16,15,0.4838709677419355,0.5161290322580645
332,2501018,"[4.0, 7.0, 8.0, 14.0, 15.0, 16.0, 17.0, 22.0, 23.0, 25.0, 27.0, 27.0, 29.0, 29.0, 33.0, 35.0, 39.0, 42.0, 46.0, 47.0, 43.0, 44.0, 47.0, 49.0, 50.0, 51.0, 54.0, 61.0, 66.0, 71.0, 77.0, 77.0, 86.0]",33,13,20,0.6060606060606061,0.3939393939393939
333,2501019,"[2.0, 2.0, 4.0, 7.0, 15.0, 17.0, 20.0, 23.0, 31.0, 31.0, 34.0, 41.0, 53.0, 55.0, 57.0, 62.0, 62.0, 63.0, 72.0, 79.0, 79.0, 83.0, 85.0, 86.0]",24,12,12,0.5,0.5
334,2501020,"[3.0, 4.0, 10.0, 10.0, 10.0, 11.0, 13.0, 15.0, 16.0, 17.0, 31.0, 34.0, 37.0, 40.0, 42.0, 45.0, 42.0, 48.0, 50.0, 52.0, 53.0, 55.0, 57.0, 57.0, 62.0, 64.0, 66.0, 68.0, 77.0, 78.0, 86.0]",31,15,16,0.5161290322580645,0.4838709677419355
335,2501021,"[8.0, 10.0, 13.0, 18.0, 18.0, 21.0, 28.0, 29.0, 31.0, 33.0, 33.0, 43.0, 57.0, 61.0, 62.0, 65.0, 67.0, 83.0, 86.0, 87.0, 88.0]",21,9,12,0.5714285714285714,0.42857142857142855
336,2501022,"[6.0, 22.0, 32.0, 37.0, 37.0, 40.0, 41.0, 48.0, 50.0, 46.0, 48.0, 49.0, 54.0, 58.0, 58.0, 68.0, 71.0, 75.0, 80.0, 81.0, 81.0, 83.0, 84.0, 88.0, 89.0]",25,18,7,0.28,0.72
337,2501023,"[7.0, 13.0, 19.0, 23.0, 34.0, 38.0, 39.0, 41.0, 42.0, 42.0, 42.0, 41.0, 52.0, 54.0, 62.0, 65.0, 70.0, 72.0, 80.0]",19,7,12,0.631578947368421,0.3684210526315789
338,2501024,"[5.0, 7.0, 7.0, 26.0, 34.0, 35.0, 40.0, 44.0, 49.0, 57.0, 60.0, 63.0, 65.0, 69.0, 79.0, 80.0, 81.0, 82.0, 83.0, 85.0, 86.0]",21,13,8,0.38095238095238093,0.6190476190476191
339,2501025,"[6.0, 12.0, 18.0, 20.0, 28.0, 34.0, 35.0, 39.0, 42.0, 42.0, 46.0, 56.0, 58.0, 58.0, 60.0, 77.0, 79.0, 87.0, 88.0]",19,9,10,0.5263157894736842,0.47368421052631576
340,2501026,"[22.0, 32.0, 38.0, 38.0, 39.0, 45.0, 46.0, 47.0, 58.0, 60.0, 64.0, 66.0, 67.0, 67.0, 69.0, 72.0, 73.0, 75.0, 82.0, 82.0, 85.0, 87.0]",22,17,5,0.22727272727272727,0.7727272727272727
341,2501027,"[5.0, 6.0, 11.0, 16.0, 21.0, 25.0, 25.0, 27.0, 30.0, 30.0, 31.0, 33.0, 42.0, 46.0, 72.0]",15,2,13,0.8666666666666667,0.13333333333333333
342,2501028,"[4.0, 6.0, 6.0, 8.0, 12.0, 15.0, 16.0, 33.0, 35.0, 37.0, 38.0, 42.0, 42.0, 47.0, 43.0, 48.0, 54.0, 55.0, 56.0, 60.0, 64.0, 65.0, 71.0, 71.0, 74.0, 85.0, 85.0, 87.0]",28,14,14,0.5,0.5
343,2501029,"[2.0, 6.0, 6.0, 8.0, 12.0, 12.0, 20.0, 27.0, 28.0, 29.0, 31.0, 33.0, 39.0, 41.0, 42.0, 46.0, 46.0, 47.0, 50.0, 53.0, 55.0, 57.0, 57.0, 61.0, 62.0, 65.0, 65.0, 69.0, 71.0, 75.0, 77.0, 79.0, 81.0, 85.0]",34,19,15,0.4411764705882353,0.5588235294117647
344,2501030,"[7.0, 17.0, 21.0, 25.0, 29.0, 34.0, 41.0, 42.0, 41.0, 42.0, 47.0, 52.0, 52.0, 57.0, 60.0, 60.0, 62.0, 71.0, 73.0, 76.0, 77.0, 82.0]",22,12,10,0.45454545454545453,0.5454545454545454
345,2501031,"[7.0, 9.0, 19.0, 21.0, 26.0, 29.0, 36.0, 39.0, 43.0, 42.0, 43.0, 45.0, 48.0, 50.0, 53.0, 53.0, 54.0, 54.0, 56.0, 56.0, 57.0, 72.0, 73.0, 75.0, 77.0, 77.0, 79.0, 81.0, 82.0]",29,18,11,0.3793103448275862,0.6206896551724138
346,2501032,"[5.0, 7.0, 8.0, 13.0, 14.0, 15.0, 17.0, 19.0, 22.0, 22.0, 24.0, 26.0, 29.0, 29.0, 31.0, 36.0, 38.0, 42.0, 44.0, 45.0, 47.0, 62.0, 73.0, 73.0, 73.0, 73.0, 77.0, 78.0, 87.0, 90.0]",30,11,19,0.6333333333333333,0.36666666666666664
347,2501033,"[6.0, 24.0, 38.0, 41.0, 42.0, 47.0, 60.0, 60.0, 62.0, 68.0, 72.0, 79.0, 82.0, 83.0, 86.0, 87.0]",16,11,5,0.3125,0.6875
348,2501034,"[7.0, 15.0, 16.0, 21.0, 25.0, 35.0, 43.0, 45.0, 46.0, 53.0, 62.0, 62.0, 70.0, 81.0, 83.0, 84.0]",16,9,7,0.4375,0.5625
349,2501035,"[3.0, 4.0, 5.0, 13.0, 24.0, 26.0, 30.0, 32.0, 33.0, 34.0, 37.0, 42.0, 62.0, 66.0, 69.0, 73.0, 79.0]",17,5,12,0.7058823529411765,0.29411764705882354
350,2501036,"[0.0, 5.0, 9.0, 14.0, 15.0, 22.0, 25.0, 31.0, 31.0, 34.0, 34.0, 39.0, 41.0, 43.0, 41.0, 42.0, 46.0, 48.0, 49.0, 51.0, 55.0, 59.0, 68.0, 69.0, 71.0, 72.0, 73.0, 75.0, 78.0, 79.0, 82.0, 85.0, 87.0, 87.0, 89.0]",35,19,16,0.45714285714285713,0.5428571428571428
351,2501037,"[5.0, 7.0, 9.0, 12.0, 12.0, 18.0, 19.0, 20.0, 30.0, 31.0, 40.0, 43.0, 44.0, 41.0, 47.0, 48.0, 56.0, 60.0, 65.0, 79.0, 80.0, 83.0, 86.0, 88.0, 88.0]",25,11,14,0.56,0.44
352,2501038,"[14.0, 19.0, 20.0, 26.0, 34.0, 36.0, 47.0, 41.0, 44.0, 46.0, 48.0, 51.0, 59.0, 59.0, 60.0, 78.0, 79.0, 81.0, 82.0, 86.0, 86.0]",21,13,8,0.38095238095238093,0.6190476190476191
353,2501039,"[19.0, 28.0, 31.0, 33.0, 34.0, 40.0, 43.0, 41.0, 42.0, 42.0, 45.0, 47.0, 50.0, 52.0, 55.0, 61.0, 64.0, 64.0, 67.0, 71.0, 81.0, 82.0, 85.0, 85.0]",24,14,10,0.4166666666666667,0.5833333333333334
354,2501040,"[4.0, 5.0, 8.0, 12.0, 13.0, 24.0, 26.0, 26.0, 30.0, 32.0, 33.0, 38.0, 45.0, 40.0, 41.0, 42.0, 48.0, 56.0, 57.0, 57.0, 67.0, 70.0, 80.0, 87.0, 88.0]",25,10,15,0.6,0.4
355,2501041,"[11.0, 19.0, 25.0, 25.0, 27.0, 36.0, 41.0, 42.0, 41.0, 41.0, 46.0, 48.0, 48.0, 55.0, 57.0, 60.0, 64.0, 67.0, 70.0, 85.0, 87.0, 87.0, 89.0]",23,13,10,0.43478260869565216,0.5652173913043478
356,2501042,"[4.0, 14.0, 25.0, 25.0, 27.0, 30.0, 43.0, 44.0, 45.0, 47.0, 41.0, 44.0, 45.0, 58.0, 71.0, 81.0, 85.0]",17,7,10,0.5882352941176471,0.4117647058823529
357,2501043,"[11.0, 16.0, 18.0, 28.0, 30.0, 31.0, 35.0, 35.0, 35.0, 39.0, 42.0, 44.0, 42.0, 45.0, 53.0, 61.0, 63.0, 66.0, 70.0, 80.0]",20,7,13,0.65,0.35
358,2501044,"[3.0, 5.0, 29.0, 35.0, 37.0, 40.0, 43.0, 45.0, 47.0, 54.0, 55.0, 58.0, 68.0, 69.0, 78.0, 82.0, 82.0, 82.0, 82.0, 85.0, 85.0, 85.0, 86.0, 89.0]",24,17,7,0.2916666666666667,0.7083333333333334
359,2501045,"[4.0, 5.0, 9.0, 14.0, 15.0, 21.0, 33.0, 38.0, 40.0, 44.0, 48.0, 49.0, 51.0, 54.0, 55.0, 61.0, 61.0, 71.0, 77.0, 83.0, 86.0]",21,11,10,0.47619047619047616,0.5238095238095238
360,2501046,"[4.0, 8.0, 9.0, 10.0, 13.0, 15.0, 31.0, 31.0, 37.0, 38.0, 40.0, 46.0, 54.0, 57.0, 60.0, 68.0, 77.0, 81.0, 83.0, 87.0, 88.0]",21,10,11,0.5238095238095238,0.47619047619047616
361,2501047,"[5.0, 8.0, 14.0, 14.0, 15.0, 15.0, 17.0, 19.0, 25.0, 28.0, 32.0, 34.0, 39.0, 39.0, 42.0, 48.0, 50.0, 56.0, 59.0, 62.0, 68.0, 73.0, 74.0]",23,8,15,0.6521739130434783,0.34782608695652173
362,2501048,"[13.0, 16.0, 22.0, 29.0, 31.0, 38.0, 40.0, 41.0, 41.0, 44.0, 65.0, 66.0, 67.0, 68.0, 69.0, 73.0, 77.0, 79.0, 84.0, 84.0]",20,10,10,0.5,0.5
363,2501049,"[1.0, 10.0, 11.0, 13.0, 18.0, 25.0, 30.0, 32.0, 36.0, 39.0, 40.0, 41.0, 41.0, 41.0, 53.0, 54.0, 58.0, 69.0, 74.0, 76.0, 79.0, 80.0, 81.0, 82.0, 86.0, 87.0, 89.0, 89.0, 89.0, 90.0]",30,16,14,0.4666666666666667,0.5333333333333333
364,2501050,"[4.0, 10.0, 14.0, 16.0, 17.0, 25.0, 29.0, 30.0, 32.0, 40.0, 43.0, 43.0, 45.0, 42.0, 45.0, 52.0, 58.0, 60.0, 70.0, 74.0, 75.0, 78.0, 82.0, 83.0, 87.0]",25,12,13,0.52,0.48
365,2501051,"[4.0, 5.0, 10.0, 14.0, 18.0, 20.0, 25.0, 28.0, 29.0, 30.0, 38.0, 42.0, 46.0, 45.0, 46.0, 47.0, 53.0, 56.0, 58.0, 60.0, 61.0, 61.0, 65.0, 69.0, 74.0, 78.0, 79.0]",27,15,12,0.4444444444444444,0.5555555555555556
366,2501052,"[7.0, 9.0, 11.0, 16.0, 24.0, 25.0, 28.0, 30.0, 30.0, 30.0, 39.0, 42.0, 43.0, 42.0, 50.0, 52.0, 54.0, 57.0, 58.0, 59.0, 64.0, 64.0, 83.0, 84.0, 85.0, 87.0, 88.0, 88.0]",28,14,14,0.5,0.5
367,2501053,"[2.0, 6.0, 15.0, 21.0, 25.0, 25.0, 28.0, 28.0, 31.0, 34.0, 35.0, 38.0, 42.0, 47.0, 51.0, 55.0, 56.0, 59.0, 66.0, 67.0, 71.0, 78.0, 81.0, 83.0, 85.0, 87.0]",26,13,13,0.5,0.5
368,2501054,"[0.0, 9.0, 11.0, 20.0, 21.0, 25.0, 26.0, 29.0, 43.0, 44.0, 45.0, 53.0, 56.0, 62.0, 64.0, 66.0, 74.0, 74.0, 77.0, 78.0, 78.0, 80.0, 81.0]",23,13,10,0.43478260869565216,0.5652173913043478
369,2501055,"[22.0, 30.0, 30.0, 34.0, 38.0, 42.0, 47.0, 47.0, 48.0, 66.0, 68.0, 83.0, 85.0]",13,7,6,0.46153846153846156,0.5384615384615384
370,2501056,"[3.0, 12.0, 16.0, 17.0, 19.0, 21.0, 27.0, 27.0, 31.0, 42.0, 44.0, 44.0, 52.0, 53.0, 66.0, 74.0, 76.0, 83.0]",18,6,12,0.6666666666666666,0.3333333333333333
371,2501057,"[2.0, 24.0, 35.0, 43.0, 46.0, 47.0, 44.0, 45.0, 48.0, 49.0, 49.0, 51.0, 61.0, 61.0, 62.0, 70.0, 73.0, 75.0, 83.0, 84.0, 87.0]",21,16,5,0.23809523809523808,0.7619047619047619
372,2501058,"[2.0, 5.0, 7.0, 9.0, 13.0, 13.0, 17.0, 19.0, 23.0, 27.0, 38.0, 44.0, 41.0, 41.0, 43.0, 47.0, 51.0, 51.0, 52.0, 55.0, 56.0, 56.0, 74.0, 75.0, 75.0, 75.0, 77.0, 81.0, 83.0, 87.0, 88.0]",31,16,15,0.4838709677419355,0.5161290322580645
373,2501059,"[4.0, 9.0, 10.0, 12.0, 12.0, 17.0, 17.0, 20.0, 28.0, 28.0, 30.0, 32.0, 40.0, 40.0, 40.0, 41.0, 43.0, 44.0, 45.0, 45.0, 44.0, 45.0, 46.0, 57.0, 67.0, 69.0, 74.0, 75.0, 79.0, 84.0, 85.0]",31,12,19,0.6129032258064516,0.3870967741935484
374,2501060,"[9.0, 10.0, 14.0, 15.0, 15.0, 16.0, 16.0, 19.0, 22.0, 35.0, 40.0, 43.0, 40.0, 43.0, 54.0, 55.0, 57.0, 58.0, 66.0, 67.0, 72.0, 79.0]",22,8,14,0.6363636363636364,0.36363636363636365
375,2501061,"[9.0, 12.0, 31.0, 31.0, 32.0, 36.0, 40.0, 44.0, 51.0, 56.0, 58.0, 65.0, 73.0, 79.0, 80.0, 82.0, 87.0]",17,9,8,0.47058823529411764,0.5294117647058824
376,2501062,"[3.0, 13.0, 15.0, 16.0, 25.0, 26.0, 34.0, 38.0, 44.0, 46.0, 48.0, 48.0, 56.0, 71.0, 79.0, 80.0]",16,7,9,0.5625,0.4375
377,2501063,"[4.0, 5.0, 6.0, 6.0, 12.0, 28.0, 29.0, 32.0, 33.0, 39.0, 44.0, 41.0, 45.0, 51.0, 56.0, 59.0, 65.0, 68.0, 74.0, 81.0, 82.0, 85.0]",22,10,12,0.5454545454545454,0.45454545454545453
378,2501064,"[5.0, 9.0, 11.0, 11.0, 20.0, 21.0, 21.0, 22.0, 24.0, 28.0, 34.0, 34.0, 38.0, 42.0, 44.0, 44.0, 49.0, 53.0, 53.0, 56.0, 57.0, 58.0, 69.0, 75.0, 81.0, 84.0]",26,10,16,0.6153846153846154,0.38461538461538464
379,2501065,"[2.0, 3.0, 6.0, 6.0, 12.0, 16.0, 17.0, 17.0, 17.0, 18.0, 19.0, 21.0, 21.0, 24.0, 29.0, 30.0, 30.0, 36.0, 39.0, 40.0, 47.0, 47.0, 60.0, 61.0, 65.0, 71.0, 73.0, 73.0, 79.0, 80.0, 82.0, 82.0]",32,12,20,0.625,0.375
