,matchId,fouls,total fouls,early game fouls,late game fouls,early game foul density,late game foul density
0,2575959,"[1.0, 2.0, 8.0, 9.0, 11.0, 17.0, 20.0, 22.0, 27.0, 30.0, 32.0, 33.0, 34.0, 37.0, 37.0, 40.0, 47.0, 53.0, 55.0, 60.0, 66.0, 68.0, 70.0, 73.0, 83.0, 85.0, 88.0, 89.0, 91.0]",29,19,10,0.6551724137931034,0.3448275862068966
1,2575960,"[2.0, 13.0, 18.0, 19.0, 20.0, 29.0, 31.0, 39.0, 40.0, 42.0, 44.0, 46.0, 47.0, 49.0, 54.0, 58.0, 59.0, 61.0, 62.0, 71.0, 72.0, 72.0, 74.0, 76.0, 80.0, 86.0, 88.0, 92.0]",28,17,11,0.6071428571428571,0.39285714285714285
2,2575961,"[2.0, 6.0, 8.0, 8.0, 11.0, 11.0, 13.0, 19.0, 27.0, 31.0, 37.0, 45.0, 48.0, 49.0, 51.0, 52.0, 53.0, 59.0, 69.0, 71.0, 86.0, 90.0, 91.0, 93.0]",24,18,6,0.75,0.25
3,2575962,"[12.0, 23.0, 25.0, 27.0, 35.0, 37.0, 40.0, 45.0, 51.0, 74.0, 81.0, 87.0, 89.0, 91.0, 91.0, 92.0, 93.0]",17,9,8,0.5294117647058824,0.47058823529411764
4,2575963,"[4.0, 6.0, 10.0, 13.0, 15.0, 16.0, 29.0, 45.0, 47.0, 47.0, 55.0, 63.0, 65.0, 67.0, 68.0, 72.0, 81.0, 86.0, 91.0, 94.0]",20,11,9,0.55,0.45
5,2575964,"[1.0, 3.0, 3.0, 13.0, 20.0, 22.0, 32.0, 36.0, 39.0, 41.0, 47.0, 49.0, 50.0, 53.0, 59.0, 60.0, 62.0, 76.0, 77.0, 78.0, 78.0, 84.0, 88.0, 90.0]",24,15,9,0.625,0.375
6,2575965,"[1.0, 3.0, 4.0, 7.0, 13.0, 16.0, 23.0, 27.0, 32.0, 34.0, 37.0, 40.0, 50.0, 58.0, 59.0, 72.0, 75.0, 76.0, 81.0, 82.0, 88.0, 89.0, 91.0]",23,15,8,0.6521739130434783,0.34782608695652173
7,2575966,"[0.0, 2.0, 6.0, 17.0, 24.0, 27.0, 33.0, 35.0, 44.0, 48.0, 49.0, 59.0, 77.0, 79.0, 82.0, 87.0, 88.0, 89.0, 90.0, 93.0, 95.0]",21,12,9,0.5714285714285714,0.42857142857142855
8,2575967,"[0.0, 2.0, 5.0, 6.0, 7.0, 8.0, 9.0, 11.0, 16.0, 16.0, 17.0, 18.0, 20.0, 22.0, 25.0, 27.0, 31.0, 36.0, 40.0, 45.0, 46.0, 47.0, 48.0, 50.0, 50.0, 54.0, 57.0, 59.0, 60.0, 63.0, 67.0, 69.0, 74.0, 74.0, 76.0, 76.0, 77.0, 78.0, 79.0, 80.0, 81.0, 82.0, 84.0, 89.0, 91.0]",45,28,17,0.6222222222222222,0.37777777777777777
9,2575968,"[4.0, 7.0, 9.0, 11.0, 18.0, 20.0, 25.0, 29.0, 32.0, 33.0, 39.0, 57.0, 63.0, 70.0, 71.0, 76.0, 81.0, 82.0, 85.0, 88.0, 90.0, 91.0, 93.0]",23,12,11,0.5217391304347826,0.4782608695652174
10,2575969,"[4.0, 13.0, 16.0, 18.0, 28.0, 32.0, 33.0, 34.0, 38.0, 40.0, 41.0, 46.0, 48.0, 51.0, 52.0, 59.0, 63.0, 75.0, 75.0, 76.0, 78.0, 79.0, 90.0, 95.0]",24,16,8,0.6666666666666666,0.3333333333333333
11,2575970,"[12.0, 16.0, 21.0, 35.0, 36.0, 43.0, 46.0, 49.0, 61.0, 62.0, 67.0, 67.0, 71.0, 74.0, 75.0, 78.0, 84.0, 86.0, 92.0]",19,8,11,0.42105263157894735,0.5789473684210527
12,2575971,"[7.0, 12.0, 21.0, 21.0, 22.0, 24.0, 25.0, 31.0, 35.0, 36.0, 37.0, 51.0, 51.0, 59.0, 59.0, 62.0, 65.0, 66.0, 67.0, 75.0, 78.0, 79.0, 84.0, 85.0, 92.0, 92.0, 94.0]",27,15,12,0.5555555555555556,0.4444444444444444
13,2575972,"[0.0, 1.0, 1.0, 11.0, 20.0, 22.0, 22.0, 25.0, 28.0, 29.0, 33.0, 36.0, 40.0, 43.0, 45.0, 47.0, 46.0, 59.0, 59.0, 67.0, 70.0, 70.0, 77.0, 78.0, 79.0, 83.0, 87.0, 88.0, 89.0, 91.0, 92.0, 92.0]",32,19,13,0.59375,0.40625
14,2575973,"[2.0, 5.0, 7.0, 8.0, 12.0, 12.0, 16.0, 18.0, 23.0, 27.0, 35.0, 41.0, 44.0, 45.0, 50.0, 53.0, 64.0, 67.0, 68.0, 76.0, 77.0, 82.0, 93.0]",23,16,7,0.6956521739130435,0.30434782608695654
15,2575974,"[2.0, 3.0, 4.0, 5.0, 7.0, 11.0, 12.0, 13.0, 13.0, 15.0, 17.0, 20.0, 28.0, 28.0, 46.0, 48.0, 50.0, 55.0, 59.0, 60.0, 61.0, 63.0, 65.0, 68.0, 78.0, 82.0, 83.0, 87.0, 88.0, 89.0, 90.0, 91.0, 91.0, 93.0, 94.0, 97.0, 98.0]",37,19,18,0.5135135135135135,0.4864864864864865
16,2575975,"[2.0, 6.0, 8.0, 9.0, 10.0, 12.0, 24.0, 32.0, 37.0, 38.0, 41.0, 54.0, 60.0, 68.0, 68.0, 70.0, 71.0, 76.0, 78.0, 82.0, 84.0, 90.0, 91.0, 91.0]",24,12,12,0.5,0.5
17,2575976,"[1.0, 4.0, 9.0, 10.0, 18.0, 21.0, 21.0, 23.0, 29.0, 31.0, 48.0, 54.0, 56.0, 65.0, 68.0, 78.0, 84.0, 88.0, 90.0, 92.0]",20,13,7,0.65,0.35
18,2575977,"[3.0, 4.0, 5.0, 23.0, 41.0, 42.0, 44.0, 46.0, 47.0, 50.0, 58.0, 59.0, 60.0, 62.0, 64.0, 73.0, 74.0, 75.0, 79.0, 84.0, 85.0, 88.0, 91.0, 92.0]",24,12,12,0.5,0.5
19,2575978,"[6.0, 7.0, 10.0, 11.0, 12.0, 19.0, 19.0, 21.0, 23.0, 28.0, 34.0, 36.0, 37.0, 39.0, 42.0, 45.0, 48.0, 50.0, 56.0, 56.0, 70.0, 78.0, 80.0, 82.0, 86.0, 91.0, 92.0, 92.0, 93.0]",29,20,9,0.6896551724137931,0.3103448275862069
20,2575979,"[5.0, 12.0, 13.0, 15.0, 17.0, 20.0, 24.0, 25.0, 26.0, 28.0, 30.0, 34.0, 36.0, 38.0, 43.0, 53.0, 53.0, 58.0, 60.0, 61.0, 62.0, 63.0, 64.0, 66.0, 75.0, 80.0, 81.0, 85.0, 87.0, 88.0, 90.0, 94.0]",32,18,14,0.5625,0.4375
21,2575980,"[6.0, 15.0, 15.0, 21.0, 25.0, 26.0, 27.0, 30.0, 31.0, 35.0, 39.0, 43.0, 45.0, 46.0, 47.0, 50.0, 50.0, 53.0, 58.0, 59.0, 66.0, 67.0, 70.0, 71.0, 73.0, 73.0, 74.0, 78.0, 81.0, 82.0, 84.0, 86.0, 89.0, 94.0]",34,20,14,0.5882352941176471,0.4117647058823529
22,2575981,"[3.0, 4.0, 8.0, 10.0, 12.0, 17.0, 18.0, 21.0, 23.0, 29.0, 30.0, 33.0, 35.0, 35.0, 37.0, 39.0, 46.0, 46.0, 61.0, 65.0, 69.0, 72.0, 75.0, 77.0, 80.0, 80.0]",26,18,8,0.6923076923076923,0.3076923076923077
23,2575982,"[2.0, 3.0, 6.0, 9.0, 12.0, 14.0, 16.0, 19.0, 23.0, 25.0, 26.0, 28.0, 29.0, 30.0, 41.0, 42.0, 45.0, 49.0, 52.0, 57.0, 61.0, 61.0, 63.0, 69.0, 69.0, 71.0, 85.0, 87.0, 88.0, 92.0, 93.0, 94.0]",32,20,12,0.625,0.375
24,2575983,"[1.0, 8.0, 9.0, 13.0, 15.0, 17.0, 34.0, 40.0, 41.0, 41.0, 43.0, 44.0, 49.0, 50.0, 51.0, 51.0, 53.0, 55.0, 60.0, 62.0, 64.0, 80.0, 85.0, 87.0, 91.0]",25,18,7,0.72,0.28
25,2575984,"[1.0, 8.0, 13.0, 22.0, 29.0, 31.0, 31.0, 33.0, 35.0, 37.0, 41.0, 47.0, 46.0, 47.0, 49.0, 52.0, 58.0, 60.0, 63.0, 68.0, 71.0, 72.0, 75.0, 76.0, 82.0, 86.0, 88.0, 92.0]",28,17,11,0.6071428571428571,0.39285714285714285
26,2575985,"[2.0, 5.0, 10.0, 11.0, 15.0, 22.0, 24.0, 29.0, 33.0, 41.0, 45.0, 46.0, 49.0, 51.0, 52.0, 63.0, 69.0, 74.0, 79.0, 81.0, 86.0, 92.0]",22,15,7,0.6818181818181818,0.3181818181818182
27,2575986,"[4.0, 6.0, 10.0, 17.0, 20.0, 21.0, 24.0, 26.0, 28.0, 29.0, 37.0, 40.0, 41.0, 55.0, 57.0, 61.0, 61.0, 62.0, 67.0, 69.0, 73.0, 78.0, 78.0, 87.0, 91.0, 92.0]",26,15,11,0.5769230769230769,0.4230769230769231
28,2575987,"[2.0, 8.0, 14.0, 17.0, 19.0, 32.0, 35.0, 37.0, 37.0, 40.0, 43.0, 47.0, 50.0, 61.0, 66.0, 79.0, 84.0, 84.0, 89.0, 92.0, 94.0]",21,13,8,0.6190476190476191,0.38095238095238093
29,2575988,"[6.0, 10.0, 12.0, 14.0, 18.0, 19.0, 24.0, 28.0, 31.0, 32.0, 39.0, 41.0, 42.0, 51.0, 55.0, 58.0, 60.0, 66.0, 69.0, 70.0, 78.0, 84.0, 85.0, 86.0, 87.0, 88.0, 90.0, 91.0, 92.0, 93.0]",30,16,14,0.5333333333333333,0.4666666666666667
30,2575989,"[1.0, 4.0, 6.0, 7.0, 8.0, 9.0, 19.0, 21.0, 23.0, 32.0, 41.0, 43.0, 48.0, 49.0, 54.0, 61.0, 64.0, 75.0, 78.0, 79.0, 80.0, 83.0, 88.0, 89.0]",24,15,9,0.625,0.375
31,2575990,"[2.0, 3.0, 15.0, 20.0, 36.0, 37.0, 39.0, 44.0, 48.0, 59.0, 62.0, 79.0, 81.0, 82.0, 91.0, 93.0, 96.0]",17,10,7,0.5882352941176471,0.4117647058823529
32,2575991,"[2.0, 4.0, 8.0, 10.0, 15.0, 18.0, 23.0, 28.0, 34.0, 45.0, 47.0, 49.0, 57.0, 64.0, 67.0, 73.0, 75.0, 79.0, 82.0, 85.0, 87.0, 89.0, 91.0, 92.0]",24,13,11,0.5416666666666666,0.4583333333333333
33,2575992,"[1.0, 2.0, 8.0, 11.0, 14.0, 22.0, 32.0, 33.0, 35.0, 35.0, 36.0, 39.0, 41.0, 43.0, 46.0, 65.0, 72.0, 75.0, 76.0, 86.0, 92.0, 93.0]",22,15,7,0.6818181818181818,0.3181818181818182
34,2575993,"[12.0, 13.0, 14.0, 15.0, 18.0, 20.0, 24.0, 26.0, 38.0, 39.0, 40.0, 43.0, 46.0, 49.0, 51.0, 56.0, 60.0, 61.0, 69.0, 72.0, 86.0, 92.0, 93.0]",23,16,7,0.6956521739130435,0.30434782608695654
35,2575994,"[24.0, 25.0, 33.0, 33.0, 36.0, 38.0, 40.0, 44.0, 62.0, 64.0, 76.0, 88.0, 89.0]",13,8,5,0.6153846153846154,0.38461538461538464
36,2575995,"[13.0, 15.0, 18.0, 23.0, 25.0, 31.0, 32.0, 32.0, 43.0, 45.0, 49.0, 52.0, 59.0, 65.0, 70.0, 72.0, 83.0, 89.0]",18,13,5,0.7222222222222222,0.2777777777777778
37,2575996,"[7.0, 8.0, 8.0, 15.0, 17.0, 22.0, 23.0, 30.0, 32.0, 35.0, 44.0, 46.0, 47.0, 48.0, 54.0, 55.0, 55.0, 59.0, 61.0, 65.0, 65.0, 67.0, 77.0, 79.0, 85.0, 85.0, 88.0, 92.0]",28,18,10,0.6428571428571429,0.35714285714285715
38,2575997,"[3.0, 4.0, 10.0, 11.0, 13.0, 23.0, 24.0, 31.0, 32.0, 34.0, 37.0, 38.0, 39.0, 40.0, 41.0, 42.0, 46.0, 47.0, 48.0, 50.0, 52.0, 55.0, 59.0, 60.0, 64.0, 70.0, 77.0, 79.0, 81.0, 82.0, 87.0, 91.0, 94.0]",33,23,10,0.696969696969697,0.30303030303030304
39,2575998,"[1.0, 2.0, 2.0, 3.0, 4.0, 11.0, 26.0, 30.0, 31.0, 35.0, 37.0, 49.0, 50.0, 55.0, 58.0, 59.0, 60.0, 67.0, 71.0, 73.0, 75.0, 79.0, 81.0, 83.0, 87.0, 89.0, 90.0, 91.0]",28,16,12,0.5714285714285714,0.42857142857142855
40,2575999,"[0.0, 7.0, 20.0, 29.0, 30.0, 30.0, 36.0, 37.0, 40.0, 41.0, 46.0, 49.0, 51.0, 52.0, 54.0, 54.0, 56.0, 73.0, 80.0, 81.0, 84.0, 85.0, 89.0, 89.0]",24,17,7,0.7083333333333334,0.2916666666666667
41,2576000,"[1.0, 2.0, 4.0, 16.0, 21.0, 38.0, 53.0, 56.0, 73.0, 73.0, 77.0, 79.0, 80.0, 82.0, 84.0, 86.0, 88.0]",17,8,9,0.47058823529411764,0.5294117647058824
42,2576001,"[0.0, 1.0, 3.0, 7.0, 10.0, 12.0, 19.0, 25.0, 28.0, 28.0, 28.0, 41.0, 43.0, 43.0, 48.0, 51.0, 56.0, 60.0, 61.0, 63.0, 71.0, 74.0, 76.0, 77.0, 81.0, 82.0, 84.0, 85.0, 91.0, 92.0, 92.0, 93.0]",32,17,15,0.53125,0.46875
43,2576002,"[7.0, 10.0, 11.0, 13.0, 15.0, 17.0, 22.0, 23.0, 25.0, 27.0, 28.0, 29.0, 33.0, 40.0, 44.0, 45.0, 52.0, 55.0, 58.0, 63.0, 64.0, 65.0, 68.0, 70.0, 73.0, 76.0, 78.0, 78.0, 82.0, 83.0, 85.0, 88.0, 91.0, 92.0, 93.0]",35,19,16,0.5428571428571428,0.45714285714285713
44,2576003,"[13.0, 14.0, 17.0, 18.0, 23.0, 28.0, 30.0, 33.0, 37.0, 39.0, 40.0, 42.0, 43.0, 44.0, 51.0, 53.0, 54.0, 70.0, 72.0, 74.0, 80.0, 86.0, 88.0, 89.0, 89.0, 91.0]",26,17,9,0.6538461538461539,0.34615384615384615
45,2576004,"[3.0, 12.0, 15.0, 18.0, 19.0, 20.0, 23.0, 25.0, 26.0, 31.0, 33.0, 44.0, 45.0, 54.0, 62.0, 65.0, 66.0, 68.0, 75.0, 83.0, 85.0, 94.0, 94.0]",23,14,9,0.6086956521739131,0.391304347826087
46,2576005,"[1.0, 2.0, 3.0, 4.0, 5.0, 7.0, 7.0, 10.0, 11.0, 12.0, 15.0, 17.0, 23.0, 27.0, 36.0, 37.0, 40.0, 45.0, 46.0, 50.0, 52.0, 54.0, 56.0, 63.0, 63.0, 64.0, 68.0, 74.0, 75.0, 77.0, 87.0, 92.0, 95.0]",33,23,10,0.696969696969697,0.30303030303030304
47,2576006,"[2.0, 3.0, 4.0, 5.0, 9.0, 15.0, 20.0, 20.0, 25.0, 32.0, 34.0, 41.0, 45.0, 48.0, 50.0, 57.0, 68.0, 69.0, 74.0, 79.0, 85.0, 91.0]",22,16,6,0.7272727272727273,0.2727272727272727
48,2576007,"[0.0, 6.0, 8.0, 13.0, 23.0, 24.0, 26.0, 29.0, 29.0, 32.0, 36.0, 38.0, 45.0, 46.0, 47.0, 48.0, 51.0, 52.0, 56.0, 57.0, 59.0, 65.0, 67.0, 69.0, 70.0, 74.0, 77.0, 85.0, 85.0, 87.0, 87.0, 89.0, 92.0]",33,21,12,0.6363636363636364,0.36363636363636365
49,2576008,"[0.0, 2.0, 3.0, 3.0, 7.0, 9.0, 10.0, 15.0, 17.0, 21.0, 23.0, 26.0, 27.0, 29.0, 31.0, 35.0, 41.0, 47.0, 48.0, 49.0, 52.0, 53.0, 60.0, 68.0, 72.0, 78.0, 79.0, 82.0, 84.0, 88.0, 88.0, 90.0, 90.0]",33,22,11,0.6666666666666666,0.3333333333333333
50,2576009,"[2.0, 3.0, 4.0, 8.0, 10.0, 12.0, 13.0, 17.0, 18.0, 26.0, 26.0, 27.0, 28.0, 36.0, 36.0, 38.0, 42.0, 45.0, 45.0, 46.0, 46.0, 52.0, 54.0, 59.0, 63.0, 64.0, 65.0, 66.0, 69.0, 71.0, 75.0, 77.0, 78.0, 79.0, 80.0, 82.0, 84.0, 84.0, 85.0, 85.0, 91.0, 91.0]",42,24,18,0.5714285714285714,0.42857142857142855
51,2576010,"[9.0, 21.0, 22.0, 25.0, 29.0, 31.0, 32.0, 35.0, 36.0, 42.0, 45.0, 45.0, 53.0, 56.0, 70.0, 77.0, 78.0, 82.0, 83.0, 87.0, 88.0, 89.0, 91.0]",23,14,9,0.6086956521739131,0.391304347826087
52,2576011,"[1.0, 1.0, 4.0, 4.0, 7.0, 9.0, 12.0, 13.0, 17.0, 18.0, 20.0, 23.0, 25.0, 29.0, 36.0, 37.0, 39.0, 44.0, 45.0, 49.0, 50.0, 57.0, 60.0, 63.0, 69.0, 74.0, 75.0, 78.0, 87.0, 89.0, 90.0, 92.0, 95.0]",33,22,11,0.6666666666666666,0.3333333333333333
53,2576012,"[8.0, 13.0, 15.0, 17.0, 20.0, 22.0, 22.0, 26.0, 32.0, 39.0, 41.0, 47.0, 51.0, 61.0, 61.0, 65.0, 73.0, 73.0, 77.0, 80.0, 88.0]",21,13,8,0.6190476190476191,0.38095238095238093
54,2576013,"[2.0, 2.0, 6.0, 11.0, 17.0, 25.0, 34.0, 37.0, 38.0, 38.0, 45.0, 52.0, 62.0, 64.0, 66.0, 72.0, 79.0, 82.0, 83.0, 88.0, 89.0, 90.0, 92.0, 93.0]",24,12,12,0.5,0.5
55,2576014,"[1.0, 2.0, 4.0, 7.0, 9.0, 18.0, 19.0, 23.0, 24.0, 26.0, 33.0, 36.0, 37.0, 39.0, 39.0, 42.0, 43.0, 46.0, 48.0, 49.0, 50.0, 53.0, 59.0, 61.0, 67.0, 76.0, 82.0, 82.0, 84.0]",29,23,6,0.7931034482758621,0.20689655172413793
56,2576015,"[3.0, 10.0, 20.0, 23.0, 24.0, 25.0, 27.0, 31.0, 39.0, 41.0, 43.0, 48.0, 50.0, 72.0, 79.0, 83.0, 84.0, 87.0, 91.0]",19,13,6,0.6842105263157895,0.3157894736842105
57,2576016,"[7.0, 8.0, 11.0, 15.0, 20.0, 20.0, 21.0, 24.0, 25.0, 28.0, 30.0, 33.0, 35.0, 46.0, 47.0, 50.0, 51.0, 51.0, 53.0, 54.0, 58.0, 59.0, 59.0, 62.0, 63.0, 72.0, 80.0, 81.0, 82.0, 82.0, 85.0, 86.0]",32,23,9,0.71875,0.28125
58,2576017,"[3.0, 3.0, 9.0, 9.0, 11.0, 19.0, 20.0, 24.0, 30.0, 32.0, 33.0, 35.0, 38.0, 48.0, 52.0, 54.0, 64.0, 71.0, 73.0, 74.0, 75.0, 79.0, 83.0, 83.0, 85.0, 89.0, 91.0]",27,16,11,0.5925925925925926,0.4074074074074074
59,2576018,"[9.0, 10.0, 22.0, 27.0, 31.0, 38.0, 40.0, 41.0, 47.0, 50.0, 52.0, 66.0, 67.0, 69.0, 74.0, 76.0, 81.0, 86.0, 87.0, 92.0, 93.0]",21,11,10,0.5238095238095238,0.47619047619047616
60,2576019,"[0.0, 10.0, 12.0, 15.0, 16.0, 17.0, 20.0, 23.0, 28.0, 29.0, 32.0, 37.0, 38.0, 40.0, 44.0, 47.0, 50.0, 53.0, 56.0, 59.0, 60.0, 63.0, 65.0, 66.0, 73.0, 74.0, 80.0, 81.0, 85.0, 88.0, 91.0, 93.0, 96.0]",33,20,13,0.6060606060606061,0.3939393939393939
61,2576020,"[0.0, 2.0, 10.0, 11.0, 13.0, 17.0, 20.0, 31.0, 35.0, 43.0, 52.0, 54.0, 54.0, 64.0, 67.0, 67.0, 69.0, 73.0, 77.0, 79.0, 80.0, 93.0, 94.0]",23,13,10,0.5652173913043478,0.43478260869565216
62,2576021,"[1.0, 7.0, 12.0, 23.0, 26.0, 30.0, 39.0, 45.0, 57.0, 58.0, 60.0, 65.0, 75.0, 77.0, 81.0, 82.0, 85.0, 86.0, 87.0, 88.0]",20,10,10,0.5,0.5
63,2576022,"[1.0, 2.0, 3.0, 5.0, 22.0, 27.0, 30.0, 32.0, 37.0, 39.0, 41.0, 43.0, 48.0, 50.0, 52.0, 54.0, 56.0, 58.0, 66.0, 75.0, 79.0, 81.0, 82.0, 84.0, 88.0]",25,18,7,0.72,0.28
64,2576023,"[7.0, 8.0, 14.0, 23.0, 24.0, 25.0, 28.0, 30.0, 31.0, 36.0, 37.0, 44.0, 47.0, 46.0, 50.0, 53.0, 60.0, 65.0, 67.0, 77.0, 80.0]",21,16,5,0.7619047619047619,0.23809523809523808
65,2576024,"[1.0, 15.0, 22.0, 31.0, 32.0, 33.0, 44.0, 45.0, 47.0, 47.0, 50.0, 50.0, 55.0, 56.0, 57.0, 59.0, 60.0, 62.0, 65.0, 76.0, 79.0, 85.0, 86.0]",23,16,7,0.6956521739130435,0.30434782608695654
66,2576025,"[1.0, 2.0, 10.0, 39.0, 41.0, 44.0, 45.0, 45.0, 48.0, 55.0, 55.0, 56.0, 63.0, 69.0, 79.0, 82.0]",16,12,4,0.75,0.25
67,2576026,"[4.0, 7.0, 12.0, 17.0, 18.0, 21.0, 32.0, 33.0, 34.0, 37.0, 43.0, 44.0, 45.0, 45.0, 54.0, 60.0, 63.0, 64.0, 64.0, 71.0, 72.0, 83.0, 83.0, 86.0, 87.0, 89.0, 93.0]",27,15,12,0.5555555555555556,0.4444444444444444
68,2576027,"[0.0, 7.0, 26.0, 27.0, 33.0, 42.0, 46.0, 48.0, 50.0, 50.0, 53.0, 56.0, 65.0, 68.0, 73.0, 78.0, 78.0, 79.0, 83.0, 84.0, 86.0, 89.0, 90.0, 93.0, 94.0, 95.0, 97.0]",27,12,15,0.4444444444444444,0.5555555555555556
69,2576028,"[8.0, 13.0, 14.0, 15.0, 17.0, 26.0, 28.0, 31.0, 39.0, 39.0, 43.0, 54.0, 65.0, 70.0, 71.0, 75.0, 79.0, 82.0, 89.0, 91.0, 92.0, 93.0, 94.0]",23,12,11,0.5217391304347826,0.4782608695652174
70,2576029,"[0.0, 1.0, 7.0, 12.0, 14.0, 16.0, 18.0, 23.0, 24.0, 25.0, 26.0, 28.0, 28.0, 32.0, 39.0, 41.0, 44.0, 46.0, 47.0, 52.0, 52.0, 55.0, 60.0, 60.0, 64.0, 69.0, 72.0, 77.0, 78.0, 80.0, 81.0, 84.0, 86.0, 90.0, 90.0]",35,22,13,0.6285714285714286,0.37142857142857144
71,2576030,"[1.0, 1.0, 3.0, 5.0, 9.0, 15.0, 17.0, 18.0, 19.0, 23.0, 25.0, 26.0, 30.0, 32.0, 32.0, 37.0, 42.0, 45.0, 45.0, 55.0, 57.0, 61.0, 61.0, 62.0, 69.0, 77.0, 80.0, 94.0]",28,21,7,0.75,0.25
72,2576031,"[2.0, 4.0, 20.0, 22.0, 24.0, 30.0, 33.0, 37.0, 38.0, 42.0, 51.0, 56.0, 57.0, 59.0, 60.0, 61.0, 66.0, 68.0, 70.0, 70.0, 71.0, 83.0, 87.0]",23,14,9,0.6086956521739131,0.391304347826087
73,2576032,"[1.0, 6.0, 10.0, 13.0, 16.0, 19.0, 21.0, 30.0, 38.0, 38.0, 39.0, 40.0, 44.0, 44.0, 50.0, 53.0, 53.0, 58.0, 68.0, 70.0, 72.0, 73.0, 75.0, 80.0, 84.0, 89.0]",26,18,8,0.6923076923076923,0.3076923076923077
74,2576033,"[1.0, 3.0, 11.0, 13.0, 13.0, 18.0, 19.0, 20.0, 21.0, 22.0, 26.0, 29.0, 31.0, 36.0, 36.0, 42.0, 49.0, 58.0, 61.0, 65.0, 66.0, 72.0, 75.0, 76.0, 83.0, 85.0, 86.0, 87.0]",28,18,10,0.6428571428571429,0.35714285714285715
75,2576034,"[3.0, 13.0, 15.0, 16.0, 20.0, 21.0, 24.0, 25.0, 26.0, 29.0, 33.0, 36.0, 38.0, 38.0, 40.0, 42.0, 45.0, 46.0, 53.0, 64.0, 65.0, 69.0, 70.0, 77.0, 79.0, 85.0, 86.0, 87.0, 88.0, 91.0, 93.0]",31,19,12,0.6129032258064516,0.3870967741935484
76,2576035,"[8.0, 9.0, 9.0, 14.0, 16.0, 20.0, 29.0, 30.0, 31.0, 32.0, 34.0, 37.0, 46.0, 49.0, 50.0, 52.0, 62.0, 77.0, 79.0, 86.0, 86.0, 92.0, 94.0, 94.0]",24,16,8,0.6666666666666666,0.3333333333333333
77,2576036,"[3.0, 7.0, 16.0, 30.0, 40.0, 41.0, 42.0, 43.0, 53.0, 62.0, 66.0, 67.0, 72.0, 75.0, 76.0, 79.0, 86.0, 88.0, 90.0, 91.0, 93.0]",21,9,12,0.42857142857142855,0.5714285714285714
78,2576037,"[15.0, 16.0, 17.0, 18.0, 23.0, 26.0, 29.0, 30.0, 36.0, 41.0, 43.0, 44.0, 52.0, 52.0, 56.0, 56.0, 64.0, 71.0, 74.0, 82.0, 83.0, 85.0, 88.0, 90.0, 91.0, 92.0]",26,16,10,0.6153846153846154,0.38461538461538464
79,2576038,"[6.0, 9.0, 10.0, 10.0, 13.0, 28.0, 36.0, 37.0, 42.0, 44.0, 45.0, 46.0, 48.0, 52.0, 54.0, 60.0, 62.0, 63.0, 65.0, 79.0, 82.0, 86.0, 88.0]",23,15,8,0.6521739130434783,0.34782608695652173
80,2576039,"[4.0, 6.0, 8.0, 8.0, 12.0, 13.0, 16.0, 19.0, 19.0, 23.0, 30.0, 32.0, 37.0, 39.0, 42.0, 55.0, 61.0, 64.0, 65.0, 66.0, 68.0, 71.0, 72.0, 74.0, 80.0, 82.0, 92.0]",27,16,11,0.5925925925925926,0.4074074074074074
81,2576040,"[0.0, 1.0, 4.0, 5.0, 9.0, 10.0, 12.0, 14.0, 15.0, 19.0, 23.0, 24.0, 27.0, 38.0, 39.0, 42.0, 43.0, 45.0, 45.0, 49.0, 55.0, 60.0, 64.0, 64.0, 67.0, 68.0, 73.0, 74.0, 75.0, 76.0, 78.0, 81.0, 84.0, 89.0, 92.0]",35,21,14,0.6,0.4
82,2576041,"[2.0, 7.0, 9.0, 10.0, 12.0, 17.0, 22.0, 29.0, 33.0, 35.0, 39.0, 44.0, 46.0, 46.0, 48.0, 49.0, 49.0, 53.0, 57.0, 59.0, 67.0, 92.0]",22,20,2,0.9090909090909091,0.09090909090909091
83,2576042,"[3.0, 5.0, 11.0, 18.0, 22.0, 28.0, 29.0, 29.0, 31.0, 35.0, 44.0, 46.0, 47.0, 48.0, 50.0, 50.0, 52.0, 57.0, 64.0, 68.0, 68.0, 70.0, 70.0, 71.0, 72.0, 74.0, 80.0, 81.0]",28,18,10,0.6428571428571429,0.35714285714285715
84,2576043,"[10.0, 12.0, 20.0, 21.0, 22.0, 27.0, 28.0, 30.0, 35.0, 37.0, 39.0, 39.0, 45.0, 47.0, 46.0, 47.0, 48.0, 52.0, 52.0, 54.0, 56.0, 57.0, 58.0, 60.0, 61.0, 63.0, 71.0, 71.0, 72.0, 76.0, 79.0, 85.0, 87.0, 89.0, 93.0]",35,23,12,0.6571428571428571,0.34285714285714286
85,2576044,"[1.0, 3.0, 12.0, 18.0, 38.0, 41.0, 45.0, 48.0, 49.0, 51.0, 65.0, 66.0, 67.0, 81.0, 83.0, 87.0, 88.0, 91.0]",18,10,8,0.5555555555555556,0.4444444444444444
86,2576045,"[1.0, 2.0, 5.0, 6.0, 10.0, 13.0, 18.0, 19.0, 21.0, 25.0, 26.0, 28.0, 33.0, 40.0, 42.0, 47.0, 49.0, 52.0, 54.0, 57.0, 58.0, 59.0, 60.0, 65.0, 73.0, 77.0, 78.0, 82.0, 82.0, 84.0, 87.0, 89.0]",32,22,10,0.6875,0.3125
87,2576046,"[2.0, 6.0, 10.0, 13.0, 15.0, 17.0, 19.0, 19.0, 23.0, 36.0, 38.0, 42.0, 48.0, 53.0, 53.0, 54.0, 55.0, 62.0, 63.0, 65.0, 68.0, 69.0, 72.0, 74.0, 75.0, 76.0, 80.0, 81.0, 84.0, 87.0, 89.0, 90.0, 95.0]",33,17,16,0.5151515151515151,0.48484848484848486
88,2576047,"[1.0, 2.0, 4.0, 8.0, 9.0, 9.0, 12.0, 17.0, 18.0, 19.0, 21.0, 22.0, 23.0, 24.0, 25.0, 25.0, 27.0, 32.0, 35.0, 40.0, 41.0, 46.0, 48.0, 50.0, 53.0, 55.0, 56.0, 61.0, 62.0, 64.0, 65.0, 67.0, 74.0, 76.0, 77.0, 79.0, 81.0, 84.0, 85.0, 90.0, 92.0]",41,27,14,0.6585365853658537,0.34146341463414637
89,2576048,"[2.0, 9.0, 11.0, 12.0, 14.0, 15.0, 15.0, 23.0, 25.0, 25.0, 25.0, 31.0, 32.0, 34.0, 39.0, 43.0, 45.0, 46.0, 48.0, 49.0, 50.0, 54.0, 55.0, 57.0, 61.0, 65.0, 71.0, 76.0, 80.0, 83.0, 88.0]",31,24,7,0.7741935483870968,0.22580645161290322
90,2576049,"[2.0, 21.0, 22.0, 26.0, 26.0, 29.0, 35.0, 40.0, 43.0, 49.0, 51.0, 51.0, 60.0, 65.0, 68.0, 73.0, 73.0, 79.0, 85.0, 88.0, 93.0]",21,12,9,0.5714285714285714,0.42857142857142855
91,2576050,"[2.0, 18.0, 27.0, 36.0, 40.0, 47.0, 47.0, 53.0, 54.0, 57.0, 58.0, 61.0, 70.0, 72.0, 75.0, 77.0, 78.0, 80.0, 82.0, 84.0, 89.0]",21,11,10,0.5238095238095238,0.47619047619047616
92,2576051,"[5.0, 6.0, 7.0, 8.0, 11.0, 12.0, 13.0, 14.0, 19.0, 23.0, 24.0, 28.0, 29.0, 34.0, 40.0, 44.0, 45.0, 46.0, 48.0, 47.0, 50.0, 52.0, 54.0, 55.0, 61.0, 69.0, 73.0, 74.0, 75.0, 76.0, 80.0, 81.0, 82.0, 83.0, 84.0, 88.0, 89.0, 90.0, 91.0, 91.0, 96.0]",41,24,17,0.5853658536585366,0.4146341463414634
93,2576052,"[1.0, 2.0, 3.0, 7.0, 10.0, 12.0, 13.0, 14.0, 16.0, 19.0, 26.0, 33.0, 34.0, 44.0, 49.0, 56.0, 64.0, 67.0, 68.0, 69.0, 72.0, 81.0, 82.0, 86.0]",24,16,8,0.6666666666666666,0.3333333333333333
94,2576053,"[4.0, 6.0, 7.0, 8.0, 11.0, 13.0, 14.0, 17.0, 20.0, 21.0, 22.0, 23.0, 26.0, 27.0, 27.0, 31.0, 32.0, 33.0, 34.0, 34.0, 41.0, 41.0, 42.0, 46.0, 45.0, 48.0, 49.0, 50.0, 51.0, 54.0, 60.0, 64.0, 67.0, 69.0, 69.0, 70.0, 73.0, 76.0, 77.0, 78.0, 85.0, 88.0, 89.0, 91.0]",44,30,14,0.6818181818181818,0.3181818181818182
95,2576054,"[11.0, 12.0, 25.0, 34.0, 35.0, 68.0, 70.0, 73.0, 75.0, 77.0, 79.0, 85.0]",12,5,7,0.4166666666666667,0.5833333333333334
96,2576055,"[3.0, 5.0, 8.0, 10.0, 14.0, 15.0, 19.0, 26.0, 27.0, 37.0, 40.0, 46.0, 46.0, 57.0, 60.0, 60.0, 69.0, 72.0, 73.0, 75.0, 77.0, 81.0, 85.0, 88.0, 90.0]",25,14,11,0.56,0.44
97,2576056,"[1.0, 17.0, 21.0, 23.0, 26.0, 26.0, 29.0, 32.0, 35.0, 37.0, 40.0, 46.0, 47.0, 48.0, 49.0, 50.0, 56.0, 57.0, 60.0, 62.0, 73.0, 77.0, 79.0, 80.0, 82.0, 85.0, 86.0, 87.0, 91.0]",29,18,11,0.6206896551724138,0.3793103448275862
98,2576057,"[6.0, 9.0, 13.0, 16.0, 21.0, 25.0, 31.0, 32.0, 42.0, 52.0, 62.0, 71.0, 78.0, 82.0, 83.0, 85.0, 93.0]",17,10,7,0.5882352941176471,0.4117647058823529
99,2576058,"[3.0, 6.0, 6.0, 11.0, 13.0, 24.0, 27.0, 28.0, 29.0, 30.0, 36.0, 37.0, 38.0, 39.0, 45.0, 46.0, 47.0, 48.0, 51.0, 53.0, 55.0, 59.0, 69.0, 74.0, 75.0, 82.0, 84.0, 85.0, 86.0, 90.0, 91.0, 92.0, 93.0, 94.0, 95.0]",35,22,13,0.6285714285714286,0.37142857142857144
100,2576059,"[0.0, 6.0, 8.0, 11.0, 17.0, 19.0, 21.0, 21.0, 31.0, 33.0, 42.0, 44.0, 44.0, 50.0, 58.0, 63.0, 68.0, 78.0, 80.0, 85.0, 90.0, 92.0]",22,15,7,0.6818181818181818,0.3181818181818182
101,2576060,"[4.0, 8.0, 11.0, 12.0, 22.0, 24.0, 31.0, 32.0, 34.0, 34.0, 35.0, 39.0, 45.0, 46.0, 47.0, 48.0, 50.0, 51.0, 52.0, 58.0, 58.0, 62.0, 62.0, 66.0, 67.0, 70.0, 73.0, 73.0, 74.0, 75.0, 78.0, 79.0, 82.0, 83.0, 84.0, 87.0, 88.0, 88.0]",38,21,17,0.5526315789473685,0.4473684210526316
102,2576061,"[5.0, 6.0, 24.0, 32.0, 38.0, 39.0, 46.0, 49.0, 50.0, 54.0, 62.0, 65.0, 68.0, 69.0, 72.0, 80.0, 88.0, 89.0, 91.0, 94.0, 95.0]",21,10,11,0.47619047619047616,0.5238095238095238
103,2576062,"[1.0, 5.0, 7.0, 9.0, 10.0, 11.0, 19.0, 20.0, 22.0, 27.0, 28.0, 29.0, 31.0, 34.0, 38.0, 43.0, 46.0, 51.0, 54.0, 68.0, 69.0, 72.0, 80.0, 82.0, 85.0, 85.0, 87.0, 88.0, 89.0, 91.0, 94.0]",31,19,12,0.6129032258064516,0.3870967741935484
104,2576063,"[7.0, 9.0, 10.0, 11.0, 13.0, 14.0, 17.0, 27.0, 35.0, 36.0, 42.0, 50.0, 59.0, 60.0, 64.0, 65.0, 67.0, 72.0, 76.0, 77.0, 79.0, 81.0, 82.0, 82.0, 87.0, 89.0, 91.0]",27,13,14,0.48148148148148145,0.5185185185185185
105,2576064,"[2.0, 5.0, 10.0, 15.0, 18.0, 19.0, 21.0, 25.0, 38.0, 44.0, 47.0, 50.0, 58.0, 60.0, 68.0, 70.0, 71.0, 73.0, 74.0, 82.0, 88.0, 89.0]",22,13,9,0.5909090909090909,0.4090909090909091
106,2576065,"[3.0, 4.0, 9.0, 13.0, 14.0, 14.0, 16.0, 23.0, 25.0, 32.0, 38.0, 39.0, 50.0, 52.0, 53.0, 55.0, 60.0, 71.0, 78.0, 90.0]",20,16,4,0.8,0.2
107,2576066,"[2.0, 7.0, 8.0, 10.0, 12.0, 13.0, 14.0, 19.0, 21.0, 24.0, 27.0, 28.0, 29.0, 29.0, 32.0, 36.0, 36.0, 39.0, 42.0, 47.0, 51.0, 53.0, 58.0, 65.0, 66.0, 70.0, 71.0, 73.0, 74.0, 76.0, 76.0, 80.0, 82.0, 83.0, 85.0, 86.0, 88.0, 89.0, 92.0, 93.0]",40,23,17,0.575,0.425
108,2576067,"[2.0, 6.0, 10.0, 13.0, 14.0, 18.0, 22.0, 27.0, 35.0, 37.0, 39.0, 40.0, 41.0, 44.0, 52.0, 59.0, 60.0, 68.0, 70.0, 72.0, 72.0, 74.0, 75.0, 77.0, 77.0, 79.0, 84.0, 87.0, 90.0, 92.0, 92.0, 94.0, 95.0]",33,16,17,0.48484848484848486,0.5151515151515151
109,2576068,"[12.0, 12.0, 13.0, 18.0, 18.0, 28.0, 34.0, 38.0, 40.0, 42.0, 43.0, 45.0, 48.0, 52.0, 52.0, 53.0, 55.0, 58.0, 58.0, 61.0, 70.0, 71.0, 72.0, 75.0, 78.0, 79.0, 81.0, 82.0, 83.0, 89.0, 93.0]",31,19,12,0.6129032258064516,0.3870967741935484
110,2576069,"[5.0, 8.0, 13.0, 16.0, 20.0, 24.0, 25.0, 26.0, 27.0, 35.0, 40.0, 43.0, 45.0, 47.0, 59.0, 60.0, 65.0, 67.0, 70.0, 71.0, 79.0, 79.0, 80.0, 85.0, 87.0, 91.0, 92.0]",27,15,12,0.5555555555555556,0.4444444444444444
111,2576070,"[5.0, 6.0, 11.0, 17.0, 18.0, 19.0, 21.0, 23.0, 29.0, 31.0, 34.0, 35.0, 36.0, 41.0, 43.0, 45.0, 47.0, 50.0, 53.0, 54.0, 55.0, 56.0, 58.0, 64.0, 65.0, 72.0, 74.0, 84.0, 84.0, 94.0]",30,23,7,0.7666666666666667,0.23333333333333334
112,2576071,"[2.0, 4.0, 4.0, 8.0, 10.0, 13.0, 29.0, 30.0, 35.0, 38.0, 41.0, 43.0, 44.0, 48.0, 51.0, 61.0, 63.0, 68.0, 73.0, 78.0, 79.0, 86.0, 87.0, 88.0, 89.0, 89.0, 92.0]",27,15,12,0.5555555555555556,0.4444444444444444
113,2576072,"[0.0, 14.0, 26.0, 33.0, 34.0, 34.0, 49.0, 52.0, 57.0, 75.0, 77.0, 78.0, 81.0, 88.0, 89.0, 92.0]",16,9,7,0.5625,0.4375
114,2576073,"[6.0, 12.0, 18.0, 21.0, 25.0, 31.0, 32.0, 34.0, 35.0, 40.0, 44.0, 45.0, 47.0, 51.0, 54.0, 55.0, 56.0, 58.0, 59.0, 63.0, 64.0, 66.0, 78.0, 82.0, 83.0]",25,19,6,0.76,0.24
115,2576074,"[1.0, 3.0, 8.0, 9.0, 11.0, 17.0, 19.0, 22.0, 27.0, 30.0, 32.0, 37.0, 39.0, 44.0, 45.0, 47.0, 48.0, 51.0, 55.0, 57.0, 57.0, 61.0, 68.0, 70.0, 73.0, 76.0, 80.0, 83.0, 87.0, 87.0, 92.0]",31,21,10,0.6774193548387096,0.3225806451612903
116,2576075,"[6.0, 12.0, 13.0, 14.0, 16.0, 21.0, 21.0, 22.0, 23.0, 32.0, 35.0, 39.0, 41.0, 44.0, 44.0, 46.0, 47.0, 54.0, 55.0, 57.0, 61.0, 63.0, 63.0, 64.0, 65.0, 70.0, 80.0, 82.0, 83.0, 84.0, 85.0, 85.0, 88.0, 92.0]",34,20,14,0.5882352941176471,0.4117647058823529
117,2576076,"[2.0, 9.0, 12.0, 15.0, 17.0, 18.0, 28.0, 36.0, 37.0, 42.0, 43.0, 44.0, 46.0, 46.0, 64.0, 66.0, 69.0, 71.0, 72.0, 74.0, 78.0, 82.0, 83.0, 84.0, 85.0, 87.0, 88.0, 92.0, 92.0]",29,14,15,0.4827586206896552,0.5172413793103449
118,2576077,"[5.0, 8.0, 9.0, 11.0, 15.0, 28.0, 46.0, 49.0, 53.0, 60.0, 64.0, 67.0, 82.0, 89.0]",14,9,5,0.6428571428571429,0.35714285714285715
119,2576078,"[1.0, 2.0, 3.0, 6.0, 7.0, 11.0, 18.0, 20.0, 22.0, 22.0, 24.0, 25.0, 29.0, 30.0, 31.0, 32.0, 35.0, 42.0, 43.0, 48.0, 48.0, 46.0, 49.0, 52.0, 54.0, 55.0, 59.0, 61.0, 63.0, 69.0, 75.0, 77.0, 84.0, 86.0, 88.0, 90.0, 92.0]",37,27,10,0.7297297297297297,0.2702702702702703
120,2576079,"[1.0, 2.0, 4.0, 6.0, 8.0, 10.0, 11.0, 12.0, 16.0, 20.0, 23.0, 24.0, 27.0, 30.0, 31.0, 35.0, 37.0, 40.0, 43.0, 46.0, 48.0, 50.0, 52.0, 62.0, 65.0, 66.0, 68.0, 71.0, 76.0, 87.0, 90.0, 91.0, 92.0, 95.0]",34,23,11,0.6764705882352942,0.3235294117647059
121,2576080,"[1.0, 3.0, 4.0, 4.0, 11.0, 12.0, 13.0, 16.0, 23.0, 25.0, 27.0, 28.0, 31.0, 32.0, 35.0, 36.0, 38.0, 44.0, 53.0, 54.0, 56.0, 62.0, 66.0, 68.0, 70.0, 72.0, 74.0, 77.0, 79.0, 80.0, 89.0, 90.0, 92.0]",33,21,12,0.6363636363636364,0.36363636363636365
122,2576081,"[6.0, 7.0, 9.0, 11.0, 17.0, 18.0, 34.0, 35.0, 37.0, 38.0, 38.0, 40.0, 42.0, 45.0, 48.0, 51.0, 58.0, 61.0, 80.0, 84.0, 90.0, 93.0]",22,17,5,0.7727272727272727,0.22727272727272727
123,2576082,"[7.0, 11.0, 12.0, 16.0, 16.0, 20.0, 29.0, 33.0, 36.0, 38.0, 41.0, 42.0, 46.0, 48.0, 50.0, 53.0, 63.0, 66.0, 75.0, 78.0, 79.0, 87.0]",22,16,6,0.7272727272727273,0.2727272727272727
124,2576083,"[3.0, 4.0, 5.0, 8.0, 12.0, 16.0, 30.0, 35.0, 36.0, 38.0, 39.0, 45.0, 49.0, 53.0, 63.0, 73.0, 75.0, 82.0, 82.0, 85.0, 85.0, 89.0, 92.0, 93.0, 93.0, 94.0]",26,14,12,0.5384615384615384,0.46153846153846156
125,2576084,"[8.0, 14.0, 17.0, 18.0, 25.0, 27.0, 28.0, 31.0, 33.0, 36.0, 37.0, 42.0, 47.0, 52.0, 54.0, 59.0, 60.0, 62.0, 65.0, 66.0, 69.0, 79.0, 81.0, 86.0, 86.0, 87.0, 91.0, 94.0]",28,16,12,0.5714285714285714,0.42857142857142855
126,2576085,"[3.0, 4.0, 9.0, 11.0, 13.0, 30.0, 30.0, 34.0, 38.0, 42.0, 46.0, 46.0, 49.0, 49.0, 53.0, 54.0, 59.0, 63.0, 63.0, 64.0, 67.0, 71.0, 75.0, 77.0, 78.0, 80.0, 88.0, 89.0, 90.0, 94.0]",30,17,13,0.5666666666666667,0.43333333333333335
127,2576086,"[1.0, 2.0, 3.0, 8.0, 9.0, 18.0, 20.0, 23.0, 27.0, 31.0, 33.0, 34.0, 39.0, 39.0, 40.0, 41.0, 46.0, 59.0, 63.0, 64.0, 66.0, 68.0, 69.0, 74.0, 75.0, 91.0, 91.0, 92.0]",28,18,10,0.6428571428571429,0.35714285714285715
128,2576087,"[3.0, 4.0, 11.0, 19.0, 21.0, 28.0, 46.0, 52.0, 53.0, 54.0, 55.0, 58.0, 59.0, 60.0, 61.0, 64.0, 67.0, 69.0, 79.0, 84.0, 87.0, 87.0, 87.0, 89.0, 92.0]",25,13,12,0.52,0.48
129,2576088,"[3.0, 4.0, 7.0, 9.0, 12.0, 14.0, 18.0, 24.0, 28.0, 32.0, 35.0, 39.0, 51.0, 53.0, 56.0, 67.0, 77.0, 92.0, 95.0, 96.0]",20,15,5,0.75,0.25
130,2576089,"[5.0, 9.0, 10.0, 12.0, 14.0, 19.0, 20.0, 26.0, 32.0, 34.0, 38.0, 41.0, 47.0, 50.0, 53.0, 55.0, 62.0, 68.0, 69.0, 72.0, 77.0, 81.0, 86.0, 89.0, 91.0, 92.0, 93.0]",27,16,11,0.5925925925925926,0.4074074074074074
131,2576090,"[4.0, 13.0, 18.0, 28.0, 31.0, 37.0, 38.0, 41.0, 43.0, 47.0, 47.0, 49.0, 60.0, 60.0, 63.0, 68.0, 70.0, 88.0, 89.0]",19,12,7,0.631578947368421,0.3684210526315789
132,2576091,"[2.0, 3.0, 6.0, 8.0, 10.0, 11.0, 12.0, 15.0, 22.0, 31.0, 33.0, 37.0, 41.0, 47.0, 58.0, 60.0, 63.0, 65.0, 67.0, 68.0, 71.0, 78.0, 81.0, 89.0, 92.0, 94.0, 95.0]",27,15,12,0.5555555555555556,0.4444444444444444
133,2576092,"[3.0, 3.0, 5.0, 6.0, 7.0, 8.0, 12.0, 15.0, 18.0, 19.0, 20.0, 22.0, 23.0, 25.0, 26.0, 27.0, 27.0, 28.0, 29.0, 31.0, 32.0, 33.0, 34.0, 36.0, 41.0, 43.0, 45.0, 45.0, 49.0, 49.0, 51.0, 54.0, 61.0, 62.0, 64.0, 69.0, 71.0, 73.0, 76.0, 80.0, 85.0, 85.0, 86.0, 89.0, 91.0, 92.0]",46,32,14,0.6956521739130435,0.30434782608695654
134,2576093,"[1.0, 9.0, 11.0, 17.0, 18.0, 22.0, 23.0, 26.0, 27.0, 29.0, 42.0, 43.0, 46.0, 46.0, 52.0, 52.0, 58.0, 62.0, 63.0, 65.0, 67.0, 71.0, 73.0, 73.0, 79.0, 82.0, 83.0, 86.0, 89.0, 92.0, 93.0, 95.0]",32,17,15,0.53125,0.46875
135,2576094,"[14.0, 17.0, 24.0, 29.0, 31.0, 46.0, 49.0, 49.0, 60.0, 66.0, 76.0, 76.0, 78.0, 81.0, 84.0, 87.0, 88.0]",17,8,9,0.47058823529411764,0.5294117647058824
136,2576095,"[2.0, 4.0, 11.0, 15.0, 22.0, 24.0, 26.0, 33.0, 33.0, 38.0, 42.0, 43.0, 48.0, 49.0, 55.0, 59.0, 61.0, 76.0, 85.0, 87.0, 90.0, 94.0, 95.0, 96.0]",24,16,8,0.6666666666666666,0.3333333333333333
137,2576096,"[1.0, 4.0, 7.0, 8.0, 10.0, 11.0, 14.0, 15.0, 16.0, 19.0, 21.0, 24.0, 30.0, 34.0, 39.0, 40.0, 41.0, 42.0, 43.0, 45.0, 46.0, 46.0, 55.0, 59.0, 59.0, 60.0, 61.0, 64.0, 66.0, 72.0, 73.0, 78.0, 87.0, 88.0, 88.0, 91.0, 93.0, 93.0]",38,25,13,0.6578947368421053,0.34210526315789475
138,2576097,"[0.0, 6.0, 8.0, 10.0, 11.0, 14.0, 15.0, 18.0, 25.0, 33.0, 40.0, 44.0, 47.0, 54.0, 56.0, 57.0, 62.0, 65.0, 66.0, 66.0, 70.0, 77.0, 79.0, 86.0, 87.0, 90.0]",26,16,10,0.6153846153846154,0.38461538461538464
139,2576098,"[3.0, 4.0, 18.0, 19.0, 20.0, 21.0, 27.0, 31.0, 34.0, 46.0, 57.0, 61.0, 65.0, 66.0, 69.0, 71.0, 84.0, 85.0, 86.0, 87.0, 89.0]",21,11,10,0.5238095238095238,0.47619047619047616
140,2576099,"[1.0, 4.0, 7.0, 8.0, 12.0, 13.0, 14.0, 21.0, 24.0, 26.0, 28.0, 28.0, 44.0, 45.0, 48.0, 53.0, 66.0, 67.0, 70.0, 72.0, 74.0, 77.0, 84.0, 86.0, 87.0, 89.0, 89.0, 93.0, 93.0, 95.0]",30,16,14,0.5333333333333333,0.4666666666666667
141,2576100,"[3.0, 4.0, 7.0, 15.0, 16.0, 17.0, 19.0, 21.0, 22.0, 24.0, 24.0, 29.0, 33.0, 37.0, 38.0, 44.0, 46.0, 48.0, 53.0, 53.0, 56.0, 57.0, 58.0, 61.0, 63.0, 66.0, 66.0, 67.0, 68.0, 71.0, 77.0, 79.0, 84.0, 84.0, 86.0, 87.0, 87.0, 91.0]",38,23,15,0.6052631578947368,0.39473684210526316
142,2576101,"[7.0, 15.0, 21.0, 24.0, 31.0, 37.0, 44.0, 45.0, 45.0, 54.0, 54.0, 57.0, 59.0, 61.0, 69.0, 69.0, 87.0, 89.0, 91.0]",19,13,6,0.6842105263157895,0.3157894736842105
143,2576102,"[1.0, 8.0, 8.0, 13.0, 21.0, 38.0, 40.0, 44.0, 45.0, 56.0, 68.0, 72.0, 72.0, 80.0, 84.0, 85.0, 89.0, 91.0, 92.0]",19,10,9,0.5263157894736842,0.47368421052631576
144,2576103,"[4.0, 6.0, 10.0, 13.0, 14.0, 14.0, 16.0, 17.0, 19.0, 20.0, 21.0, 22.0, 24.0, 26.0, 32.0, 35.0, 38.0, 44.0, 47.0, 48.0, 53.0, 55.0, 56.0, 59.0, 64.0, 66.0, 67.0, 70.0, 72.0, 77.0, 79.0, 80.0, 82.0, 86.0, 88.0, 90.0, 93.0, 95.0]",38,24,14,0.631578947368421,0.3684210526315789
145,2576104,"[4.0, 6.0, 12.0, 26.0, 28.0, 31.0, 36.0, 43.0, 46.0, 47.0, 49.0, 51.0, 55.0, 61.0, 86.0]",15,13,2,0.8666666666666667,0.13333333333333333
146,2576105,"[15.0, 18.0, 20.0, 22.0, 23.0, 34.0, 35.0, 36.0, 38.0, 45.0, 52.0, 55.0, 58.0, 78.0, 90.0]",15,13,2,0.8666666666666667,0.13333333333333333
147,2576106,"[8.0, 18.0, 21.0, 26.0, 26.0, 27.0, 34.0, 40.0, 48.0, 54.0, 56.0, 58.0, 63.0, 64.0, 66.0, 67.0, 68.0, 75.0, 77.0, 82.0, 90.0, 91.0]",22,12,10,0.5454545454545454,0.45454545454545453
148,2576107,"[15.0, 18.0, 24.0, 24.0, 26.0, 30.0, 33.0, 36.0, 42.0, 44.0, 56.0, 59.0, 62.0, 67.0, 69.0, 71.0, 78.0, 82.0, 83.0, 88.0, 93.0, 94.0]",22,12,10,0.5454545454545454,0.45454545454545453
149,2576108,"[4.0, 5.0, 9.0, 11.0, 12.0, 19.0, 22.0, 30.0, 35.0, 37.0, 40.0, 46.0, 48.0, 58.0, 63.0, 66.0, 67.0, 71.0, 77.0, 78.0, 82.0, 83.0, 85.0]",23,14,9,0.6086956521739131,0.391304347826087
150,2576109,"[0.0, 4.0, 18.0, 23.0, 25.0, 28.0, 28.0, 34.0, 48.0, 48.0, 49.0, 49.0, 52.0, 55.0, 55.0, 58.0, 62.0, 66.0, 72.0, 72.0, 74.0, 75.0, 79.0, 83.0, 88.0, 92.0]",26,16,10,0.6153846153846154,0.38461538461538464
151,2576110,"[8.0, 9.0, 11.0, 20.0, 27.0, 30.0, 32.0, 38.0, 39.0, 40.0, 44.0, 45.0, 50.0, 58.0, 61.0, 68.0, 79.0, 80.0, 83.0]",19,14,5,0.7368421052631579,0.2631578947368421
152,2576111,"[3.0, 5.0, 9.0, 9.0, 10.0, 12.0, 24.0, 26.0, 30.0, 31.0, 32.0, 34.0, 36.0, 37.0, 39.0, 40.0, 41.0, 47.0, 50.0, 56.0, 58.0, 59.0, 68.0, 70.0, 71.0, 74.0, 77.0, 80.0, 83.0, 85.0, 90.0, 90.0, 91.0, 92.0, 93.0]",35,22,13,0.6285714285714286,0.37142857142857144
153,2576112,"[3.0, 7.0, 11.0, 16.0, 19.0, 20.0, 22.0, 26.0, 27.0, 28.0, 29.0, 29.0, 34.0, 35.0, 36.0, 38.0, 39.0, 39.0, 43.0, 54.0, 55.0, 58.0, 61.0, 64.0, 70.0, 73.0, 73.0, 75.0, 79.0, 80.0, 87.0, 89.0, 91.0]",33,22,11,0.6666666666666666,0.3333333333333333
154,2576113,"[7.0, 11.0, 21.0, 25.0, 27.0, 28.0, 32.0, 35.0, 40.0, 46.0, 45.0, 52.0, 67.0, 69.0, 70.0, 71.0, 76.0, 78.0, 79.0, 80.0, 82.0, 82.0, 83.0]",23,12,11,0.5217391304347826,0.4782608695652174
155,2576114,"[6.0, 8.0, 9.0, 13.0, 14.0, 21.0, 22.0, 25.0, 28.0, 39.0, 42.0, 52.0, 64.0, 65.0, 73.0, 86.0, 93.0]",17,12,5,0.7058823529411765,0.29411764705882354
156,2576115,"[0.0, 9.0, 23.0, 24.0, 30.0, 30.0, 32.0, 36.0, 39.0, 45.0, 51.0, 85.0, 86.0, 88.0, 89.0, 90.0, 92.0]",17,11,6,0.6470588235294118,0.35294117647058826
157,2576116,"[0.0, 3.0, 7.0, 9.0, 15.0, 21.0, 21.0, 23.0, 28.0, 33.0, 36.0, 42.0, 50.0, 58.0, 68.0, 72.0, 73.0, 74.0, 76.0, 78.0, 80.0, 86.0, 87.0, 88.0, 92.0]",25,14,11,0.56,0.44
158,2576117,"[2.0, 4.0, 6.0, 12.0, 16.0, 19.0, 22.0, 29.0, 30.0, 31.0, 32.0, 36.0, 39.0, 45.0, 45.0, 47.0, 52.0, 53.0, 54.0, 66.0, 74.0, 76.0, 79.0, 81.0, 85.0, 87.0, 88.0, 90.0, 92.0, 92.0, 93.0]",31,19,12,0.6129032258064516,0.3870967741935484
159,2576118,"[1.0, 6.0, 7.0, 8.0, 9.0, 12.0, 12.0, 14.0, 23.0, 25.0, 29.0, 31.0, 33.0, 34.0, 35.0, 36.0, 37.0, 43.0, 47.0, 48.0, 49.0, 50.0, 57.0, 58.0, 61.0, 67.0, 68.0, 71.0, 82.0, 90.0, 94.0]",31,24,7,0.7741935483870968,0.22580645161290322
160,2576119,"[6.0, 8.0, 14.0, 27.0, 29.0, 30.0, 32.0, 37.0, 44.0, 49.0, 53.0, 61.0, 63.0, 64.0, 71.0, 79.0, 83.0, 88.0]",18,11,7,0.6111111111111112,0.3888888888888889
161,2576120,"[2.0, 5.0, 6.0, 8.0, 13.0, 18.0, 20.0, 35.0, 37.0, 42.0, 46.0, 46.0, 46.0, 51.0, 55.0, 57.0, 57.0, 60.0, 68.0, 76.0, 78.0, 80.0, 82.0, 84.0, 85.0, 88.0, 91.0]",27,17,10,0.6296296296296297,0.37037037037037035
162,2576121,"[0.0, 5.0, 8.0, 9.0, 21.0, 22.0, 24.0, 25.0, 28.0, 30.0, 37.0, 41.0, 50.0, 59.0, 60.0, 75.0, 85.0, 91.0, 93.0]",19,14,5,0.7368421052631579,0.2631578947368421
163,2576122,"[1.0, 4.0, 6.0, 8.0, 10.0, 12.0, 17.0, 20.0, 24.0, 31.0, 34.0, 36.0, 36.0, 40.0, 44.0, 46.0, 48.0, 51.0, 52.0, 61.0, 62.0, 64.0, 65.0, 67.0, 69.0, 70.0, 76.0, 83.0, 84.0, 87.0, 94.0, 94.0]",32,19,13,0.59375,0.40625
164,2576123,"[3.0, 8.0, 11.0, 18.0, 19.0, 22.0, 23.0, 25.0, 26.0, 30.0, 34.0, 48.0, 54.0, 56.0, 58.0, 67.0, 71.0, 76.0, 80.0, 82.0, 83.0, 88.0, 89.0]",23,15,8,0.6521739130434783,0.34782608695652173
165,2576124,"[6.0, 12.0, 13.0, 17.0, 21.0, 22.0, 28.0, 31.0, 34.0, 38.0, 40.0, 40.0, 48.0, 48.0, 50.0, 53.0, 54.0, 56.0, 59.0, 62.0, 64.0, 65.0, 78.0, 82.0, 88.0, 89.0, 90.0, 93.0]",28,19,9,0.6785714285714286,0.32142857142857145
166,2576125,"[0.0, 10.0, 12.0, 16.0, 28.0, 30.0, 34.0, 42.0, 44.0, 51.0, 56.0, 62.0, 65.0, 65.0, 66.0, 69.0, 70.0, 72.0, 74.0, 79.0, 79.0, 83.0, 89.0, 90.0, 92.0, 95.0]",26,11,15,0.4230769230769231,0.5769230769230769
167,2576126,"[0.0, 1.0, 5.0, 13.0, 21.0, 23.0, 26.0, 27.0, 29.0, 31.0, 35.0, 38.0, 39.0, 40.0, 44.0, 48.0, 49.0, 53.0, 53.0, 57.0, 57.0, 59.0, 62.0, 64.0, 68.0, 74.0, 76.0, 77.0, 88.0, 90.0, 92.0]",31,22,9,0.7096774193548387,0.2903225806451613
168,2576127,"[1.0, 1.0, 3.0, 4.0, 7.0, 8.0, 12.0, 13.0, 14.0, 17.0, 24.0, 26.0, 33.0, 34.0, 36.0, 37.0, 38.0, 45.0, 48.0, 49.0, 54.0, 63.0, 65.0, 67.0, 68.0, 72.0, 74.0, 81.0, 82.0, 83.0, 85.0, 89.0, 92.0, 94.0, 95.0, 95.0]",36,21,15,0.5833333333333334,0.4166666666666667
169,2576128,"[2.0, 6.0, 21.0, 22.0, 33.0, 37.0, 37.0, 41.0, 42.0, 53.0, 59.0, 68.0, 75.0, 78.0, 82.0, 85.0, 88.0, 90.0]",18,11,7,0.6111111111111112,0.3888888888888889
170,2576129,"[3.0, 3.0, 8.0, 14.0, 16.0, 29.0, 30.0, 34.0, 34.0, 45.0, 45.0, 46.0, 51.0, 51.0, 53.0, 57.0, 58.0, 60.0, 63.0, 66.0, 67.0, 70.0, 71.0, 90.0, 93.0, 93.0, 93.0, 96.0, 97.0]",29,17,12,0.5862068965517241,0.41379310344827586
171,2576130,"[8.0, 13.0, 17.0, 19.0, 20.0, 22.0, 23.0, 24.0, 33.0, 34.0, 43.0, 44.0, 45.0, 46.0, 52.0, 60.0, 60.0, 61.0, 67.0, 72.0, 77.0, 79.0, 80.0, 83.0, 89.0, 95.0, 95.0]",27,15,12,0.5555555555555556,0.4444444444444444
172,2576131,"[1.0, 1.0, 3.0, 8.0, 9.0, 11.0, 12.0, 14.0, 17.0, 25.0, 28.0, 38.0, 39.0, 40.0, 43.0, 43.0, 44.0, 46.0, 47.0, 46.0, 47.0, 48.0, 57.0, 58.0, 60.0, 62.0, 64.0, 66.0, 74.0, 82.0, 88.0, 90.0, 92.0, 95.0]",34,24,10,0.7058823529411765,0.29411764705882354
173,2576132,"[2.0, 4.0, 9.0, 11.0, 20.0, 23.0, 25.0, 29.0, 31.0, 34.0, 38.0, 39.0, 46.0, 48.0, 52.0, 54.0, 58.0, 70.0, 72.0, 74.0, 82.0, 86.0, 92.0]",23,17,6,0.7391304347826086,0.2608695652173913
174,2576133,"[2.0, 8.0, 10.0, 14.0, 17.0, 24.0, 25.0, 27.0, 30.0, 39.0, 39.0, 41.0, 44.0, 45.0, 48.0, 53.0, 68.0, 73.0, 74.0, 79.0]",20,16,4,0.8,0.2
175,2576134,"[5.0, 9.0, 12.0, 13.0, 15.0, 21.0, 23.0, 25.0, 29.0, 30.0, 34.0, 37.0, 39.0, 45.0, 46.0, 48.0, 59.0, 65.0, 67.0, 68.0, 70.0, 75.0, 82.0, 84.0, 87.0, 89.0, 91.0]",27,17,10,0.6296296296296297,0.37037037037037035
176,2576135,"[1.0, 4.0, 6.0, 9.0, 13.0, 14.0, 17.0, 20.0, 21.0, 21.0, 26.0, 28.0, 31.0, 34.0, 36.0, 42.0, 45.0, 46.0, 49.0, 51.0, 57.0, 62.0, 66.0, 71.0, 76.0, 78.0, 80.0, 81.0, 81.0, 84.0, 88.0, 88.0, 93.0]",33,21,12,0.6363636363636364,0.36363636363636365
177,2576136,"[3.0, 12.0, 20.0, 27.0, 28.0, 28.0, 30.0, 32.0, 40.0, 40.0, 43.0, 48.0, 52.0, 55.0, 56.0, 58.0, 61.0, 64.0, 67.0, 68.0, 71.0, 72.0, 73.0, 75.0, 78.0, 81.0, 85.0, 87.0, 87.0, 89.0, 93.0, 94.0, 95.0]",33,16,17,0.48484848484848486,0.5151515151515151
178,2576137,"[1.0, 2.0, 2.0, 3.0, 5.0, 8.0, 12.0, 17.0, 21.0, 23.0, 28.0, 31.0, 34.0, 34.0, 37.0, 41.0, 46.0, 48.0, 47.0, 50.0, 55.0, 56.0, 59.0, 61.0, 63.0, 66.0, 67.0, 71.0, 80.0, 81.0, 84.0, 87.0, 89.0, 91.0, 92.0]",35,23,12,0.6571428571428571,0.34285714285714286
179,2576138,"[3.0, 6.0, 15.0, 17.0, 23.0, 29.0, 32.0, 37.0, 40.0, 43.0, 45.0, 46.0, 47.0, 48.0, 50.0, 56.0, 63.0, 65.0, 66.0, 69.0, 71.0, 73.0, 75.0, 77.0, 85.0, 87.0, 89.0, 92.0]",28,16,12,0.5714285714285714,0.42857142857142855
180,2576139,"[4.0, 8.0, 10.0, 10.0, 20.0, 21.0, 25.0, 26.0, 33.0, 35.0, 40.0, 45.0, 49.0, 51.0, 57.0, 57.0, 72.0, 73.0, 79.0, 82.0, 87.0, 89.0, 89.0, 93.0, 95.0]",25,16,9,0.64,0.36
181,2576140,"[1.0, 6.0, 10.0, 10.0, 13.0, 20.0, 22.0, 22.0, 27.0, 28.0, 30.0, 32.0, 36.0, 37.0, 41.0, 42.0, 44.0, 45.0, 50.0, 57.0, 58.0, 59.0, 60.0, 61.0, 77.0, 80.0, 86.0, 88.0, 91.0, 92.0, 92.0, 94.0]",32,22,10,0.6875,0.3125
182,2576141,"[4.0, 6.0, 9.0, 13.0, 17.0, 18.0, 22.0, 31.0, 34.0, 36.0, 45.0, 45.0, 47.0, 49.0, 50.0, 50.0, 52.0, 56.0, 58.0, 59.0, 61.0, 64.0, 64.0, 65.0, 66.0, 66.0, 75.0, 77.0, 81.0, 86.0, 90.0, 92.0, 93.0, 95.0]",34,20,14,0.5882352941176471,0.4117647058823529
183,2576142,"[6.0, 13.0, 22.0, 29.0, 39.0, 47.0, 47.0, 51.0, 69.0, 70.0, 76.0, 82.0, 84.0, 86.0, 88.0, 90.0, 93.0]",17,8,9,0.47058823529411764,0.5294117647058824
184,2576143,"[9.0, 11.0, 17.0, 19.0, 20.0, 23.0, 25.0, 32.0, 34.0, 37.0, 38.0, 42.0, 43.0, 45.0, 46.0, 47.0, 50.0, 58.0, 77.0, 80.0, 81.0, 83.0, 87.0]",23,18,5,0.782608695652174,0.21739130434782608
185,2576144,"[1.0, 10.0, 11.0, 12.0, 17.0, 22.0, 22.0, 25.0, 26.0, 30.0, 32.0, 40.0, 41.0, 43.0, 49.0, 51.0, 61.0, 65.0, 71.0, 79.0, 81.0, 83.0, 84.0, 87.0, 88.0, 89.0, 92.0, 94.0]",28,16,12,0.5714285714285714,0.42857142857142855
186,2576145,"[5.0, 6.0, 6.0, 8.0, 9.0, 23.0, 29.0, 32.0, 36.0, 41.0, 46.0, 49.0, 51.0, 54.0, 58.0, 62.0, 66.0, 68.0, 72.0, 76.0, 77.0, 78.0]",22,15,7,0.6818181818181818,0.3181818181818182
187,2576146,"[5.0, 7.0, 9.0, 10.0, 22.0, 23.0, 25.0, 26.0, 30.0, 34.0, 38.0, 39.0, 43.0, 45.0, 49.0, 51.0, 55.0, 58.0, 63.0, 65.0, 69.0, 75.0, 81.0, 81.0, 84.0, 87.0, 91.0, 93.0, 94.0]",29,18,11,0.6206896551724138,0.3793103448275862
188,2576147,"[1.0, 5.0, 10.0, 13.0, 14.0, 15.0, 21.0, 25.0, 27.0, 34.0, 36.0, 37.0, 39.0, 39.0, 43.0, 45.0, 48.0, 57.0, 60.0, 64.0, 69.0, 71.0, 71.0, 72.0, 74.0, 77.0, 78.0, 81.0, 83.0, 86.0, 86.0, 90.0, 96.0]",33,18,15,0.5454545454545454,0.45454545454545453
189,2576148,"[1.0, 3.0, 4.0, 6.0, 7.0, 9.0, 10.0, 11.0, 12.0, 19.0, 20.0, 22.0, 22.0, 24.0, 25.0, 27.0, 30.0, 31.0, 36.0, 36.0, 37.0, 37.0, 40.0, 43.0, 44.0, 46.0, 47.0, 49.0, 51.0, 52.0, 53.0, 54.0, 59.0, 60.0, 63.0, 66.0, 68.0, 69.0, 73.0, 74.0, 78.0, 85.0, 88.0, 89.0, 90.0, 91.0]",46,33,13,0.717391304347826,0.2826086956521739
190,2576149,"[6.0, 9.0, 11.0, 17.0, 27.0, 29.0, 35.0, 44.0, 46.0, 48.0, 56.0, 58.0, 63.0, 75.0, 78.0, 83.0, 83.0, 87.0, 93.0]",19,12,7,0.631578947368421,0.3684210526315789
191,2576150,"[5.0, 5.0, 11.0, 13.0, 20.0, 28.0, 29.0, 31.0, 35.0, 36.0, 37.0, 37.0, 42.0, 47.0, 45.0, 57.0, 63.0, 66.0, 68.0, 69.0, 77.0, 83.0, 90.0, 90.0]",24,16,8,0.6666666666666666,0.3333333333333333
192,2576151,"[0.0, 6.0, 7.0, 8.0, 8.0, 13.0, 17.0, 18.0, 20.0, 24.0, 26.0, 28.0, 31.0, 32.0, 33.0, 44.0, 44.0, 47.0, 48.0, 55.0, 55.0, 59.0, 65.0, 69.0, 69.0, 70.0, 73.0, 74.0, 86.0, 87.0, 92.0, 93.0, 94.0, 96.0]",34,22,12,0.6470588235294118,0.35294117647058826
193,2576152,"[6.0, 14.0, 18.0, 24.0, 27.0, 34.0, 42.0, 46.0, 46.0, 47.0, 50.0, 57.0, 67.0, 74.0, 75.0, 83.0, 85.0, 89.0]",18,12,6,0.6666666666666666,0.3333333333333333
194,2576153,"[1.0, 10.0, 12.0, 25.0, 27.0, 27.0, 30.0, 41.0, 49.0, 51.0, 54.0, 57.0, 65.0, 68.0, 68.0, 83.0, 86.0, 88.0, 89.0, 91.0, 93.0]",21,12,9,0.5714285714285714,0.42857142857142855
195,2576154,"[0.0, 6.0, 8.0, 16.0, 17.0, 20.0, 22.0, 24.0, 28.0, 29.0, 31.0, 32.0, 34.0, 38.0, 41.0, 42.0, 46.0, 47.0, 47.0, 51.0, 53.0, 53.0, 55.0, 60.0, 62.0, 71.0, 75.0, 84.0, 85.0, 90.0, 91.0]",31,23,8,0.7419354838709677,0.25806451612903225
196,2576155,"[6.0, 11.0, 27.0, 29.0, 31.0, 32.0, 38.0, 39.0, 43.0, 46.0, 53.0, 53.0, 56.0, 59.0, 62.0, 69.0, 71.0, 74.0, 76.0, 79.0, 83.0, 90.0, 91.0, 92.0]",24,14,10,0.5833333333333334,0.4166666666666667
197,2576156,"[2.0, 3.0, 5.0, 11.0, 14.0, 27.0, 31.0, 40.0, 41.0, 46.0, 54.0, 59.0, 72.0, 77.0, 81.0, 82.0, 86.0, 90.0, 93.0]",19,12,7,0.631578947368421,0.3684210526315789
198,2576157,"[0.0, 2.0, 4.0, 5.0, 7.0, 8.0, 9.0, 14.0, 17.0, 19.0, 26.0, 28.0, 29.0, 32.0, 33.0, 40.0, 43.0, 46.0, 51.0, 52.0, 54.0, 55.0, 58.0, 59.0, 63.0, 64.0, 67.0, 70.0, 75.0, 76.0, 81.0, 84.0, 85.0]",33,24,9,0.7272727272727273,0.2727272727272727
199,2576158,"[2.0, 7.0, 8.0, 13.0, 25.0, 31.0, 32.0, 34.0, 36.0, 38.0, 46.0, 47.0, 54.0, 56.0, 64.0, 65.0, 67.0, 69.0, 71.0, 74.0, 77.0, 78.0, 79.0, 80.0, 88.0, 89.0, 92.0]",27,14,13,0.5185185185185185,0.48148148148148145
200,2576159,"[2.0, 4.0, 5.0, 6.0, 13.0, 14.0, 23.0, 24.0, 25.0, 29.0, 32.0, 33.0, 43.0, 44.0, 45.0, 46.0, 46.0, 50.0, 51.0, 53.0, 54.0, 56.0, 56.0, 68.0, 70.0, 91.0]",26,23,3,0.8846153846153846,0.11538461538461539
201,2576160,"[3.0, 27.0, 37.0, 37.0, 51.0, 53.0, 56.0, 78.0]",8,7,1,0.875,0.125
202,2576161,"[2.0, 6.0, 8.0, 14.0, 16.0, 19.0, 25.0, 26.0, 27.0, 29.0, 29.0, 31.0, 31.0, 33.0, 38.0, 39.0, 41.0, 46.0, 50.0, 54.0, 61.0, 66.0, 73.0, 74.0, 81.0, 83.0, 86.0, 87.0]",28,20,8,0.7142857142857143,0.2857142857142857
203,2576162,"[4.0, 6.0, 8.0, 13.0, 21.0, 23.0, 33.0, 36.0, 37.0, 39.0, 41.0, 43.0, 45.0, 46.0, 50.0, 53.0, 56.0, 69.0, 77.0, 82.0, 82.0, 86.0]",22,17,5,0.7727272727272727,0.22727272727272727
204,2576163,"[6.0, 7.0, 8.0, 9.0, 14.0, 15.0, 15.0, 18.0, 20.0, 24.0, 27.0, 28.0, 30.0, 33.0, 36.0, 38.0, 40.0, 40.0, 41.0, 43.0, 45.0, 46.0, 47.0, 50.0, 55.0, 58.0, 61.0, 62.0, 66.0, 71.0, 72.0, 73.0, 73.0, 75.0, 78.0, 80.0, 84.0, 84.0, 84.0, 88.0, 91.0]",41,26,15,0.6341463414634146,0.36585365853658536
205,2576164,"[3.0, 5.0, 12.0, 20.0, 22.0, 25.0, 26.0, 30.0, 30.0, 33.0, 34.0, 37.0, 37.0, 41.0, 44.0, 47.0, 47.0, 48.0, 49.0, 50.0, 50.0, 52.0, 54.0, 55.0, 57.0, 62.0, 63.0, 64.0, 67.0, 72.0, 73.0, 73.0, 74.0, 79.0, 80.0, 81.0, 83.0, 84.0, 88.0, 94.0]",40,25,15,0.625,0.375
206,2576165,"[2.0, 16.0, 24.0, 26.0, 31.0, 38.0, 49.0, 51.0, 52.0, 55.0, 63.0, 67.0, 68.0, 69.0, 73.0, 74.0, 75.0, 79.0, 80.0, 81.0, 83.0, 87.0, 87.0, 93.0, 95.0]",25,10,15,0.4,0.6
207,2576166,"[4.0, 5.0, 6.0, 12.0, 13.0, 15.0, 23.0, 36.0, 38.0, 40.0, 44.0, 45.0, 48.0, 49.0, 50.0, 52.0, 54.0, 57.0, 57.0, 65.0, 68.0, 76.0, 81.0, 87.0, 90.0, 93.0]",26,19,7,0.7307692307692307,0.2692307692307692
208,2576167,"[1.0, 2.0, 3.0, 9.0, 11.0, 12.0, 14.0, 16.0, 18.0, 20.0, 22.0, 28.0, 29.0, 30.0, 34.0, 42.0, 45.0, 48.0, 46.0, 47.0, 51.0, 55.0, 57.0, 58.0, 59.0, 67.0, 69.0, 77.0, 78.0, 82.0, 85.0, 86.0, 90.0, 91.0, 93.0]",35,25,10,0.7142857142857143,0.2857142857142857
209,2576168,"[4.0, 5.0, 6.0, 7.0, 8.0, 16.0, 19.0, 20.0, 23.0, 25.0, 27.0, 28.0, 29.0, 32.0, 33.0, 38.0, 41.0, 46.0, 45.0, 46.0, 48.0, 49.0, 51.0, 62.0, 62.0, 65.0, 69.0, 76.0, 80.0, 87.0, 90.0, 91.0]",32,23,9,0.71875,0.28125
210,2576169,"[3.0, 4.0, 9.0, 15.0, 16.0, 19.0, 29.0, 31.0, 33.0, 38.0, 39.0, 39.0, 44.0, 51.0, 62.0, 63.0, 66.0, 67.0, 72.0, 92.0, 96.0]",21,14,7,0.6666666666666666,0.3333333333333333
211,2576170,"[1.0, 8.0, 10.0, 10.0, 17.0, 18.0, 22.0, 26.0, 33.0, 33.0, 37.0, 43.0, 46.0, 48.0, 52.0, 59.0, 68.0, 72.0, 80.0, 82.0, 84.0, 86.0, 87.0, 89.0]",24,16,8,0.6666666666666666,0.3333333333333333
212,2576171,"[5.0, 10.0, 18.0, 27.0, 28.0, 30.0, 34.0, 39.0, 46.0, 47.0, 49.0, 50.0, 51.0, 75.0, 76.0, 77.0, 80.0, 81.0, 84.0, 88.0]",20,13,7,0.65,0.35
213,2576172,"[1.0, 2.0, 3.0, 9.0, 11.0, 13.0, 18.0, 25.0, 26.0, 31.0, 33.0, 35.0, 39.0, 45.0, 46.0, 46.0, 50.0, 50.0, 46.0, 49.0, 55.0, 55.0, 56.0, 59.0, 61.0, 63.0, 64.0, 66.0, 67.0, 71.0, 76.0, 77.0, 79.0, 84.0, 88.0, 92.0, 95.0]",37,24,13,0.6486486486486487,0.35135135135135137
214,2576173,"[7.0, 12.0, 13.0, 14.0, 21.0, 24.0, 29.0, 34.0, 35.0, 40.0, 44.0, 46.0, 47.0, 49.0, 57.0, 58.0, 65.0, 65.0, 67.0, 68.0, 70.0, 78.0, 80.0, 80.0, 82.0, 86.0, 87.0, 91.0, 93.0]",29,16,13,0.5517241379310345,0.4482758620689655
215,2576174,"[8.0, 10.0, 14.0, 15.0, 17.0, 31.0, 35.0, 35.0, 36.0, 37.0, 40.0, 42.0, 46.0, 47.0, 49.0, 49.0, 50.0, 50.0, 51.0, 53.0, 54.0, 55.0, 56.0, 63.0, 63.0, 66.0, 68.0, 80.0, 82.0, 83.0, 85.0, 88.0, 89.0, 90.0, 91.0]",35,23,12,0.6571428571428571,0.34285714285714286
216,2576175,"[3.0, 3.0, 5.0, 6.0, 15.0, 21.0, 22.0, 25.0, 27.0, 31.0, 31.0, 32.0, 34.0, 36.0, 39.0, 41.0, 48.0, 57.0, 61.0, 69.0, 72.0]",21,18,3,0.8571428571428571,0.14285714285714285
217,2576176,"[6.0, 14.0, 24.0, 26.0, 27.0, 28.0, 30.0, 35.0, 37.0, 38.0, 41.0, 46.0, 47.0, 51.0, 55.0, 55.0, 65.0, 85.0, 85.0, 89.0, 91.0, 92.0, 93.0, 94.0]",24,16,8,0.6666666666666666,0.3333333333333333
218,2576177,"[3.0, 7.0, 13.0, 38.0, 51.0, 57.0, 62.0, 69.0, 75.0, 76.0, 79.0, 83.0, 87.0, 91.0]",14,6,8,0.42857142857142855,0.5714285714285714
219,2576178,"[5.0, 12.0, 13.0, 14.0, 15.0, 16.0, 16.0, 25.0, 29.0, 38.0, 39.0, 39.0, 45.0, 46.0, 46.0, 48.0, 49.0, 51.0, 53.0, 54.0, 55.0, 59.0, 63.0, 64.0, 67.0, 73.0, 86.0, 90.0, 91.0]",29,22,7,0.7586206896551724,0.2413793103448276
220,2576179,"[3.0, 5.0, 6.0, 8.0, 12.0, 17.0, 20.0, 28.0, 30.0, 34.0, 43.0, 48.0, 64.0, 65.0, 67.0, 68.0, 70.0, 74.0, 76.0, 80.0, 84.0, 88.0, 91.0, 92.0]",24,12,12,0.5,0.5
221,2576180,"[4.0, 9.0, 10.0, 22.0, 26.0, 28.0, 29.0, 38.0, 49.0, 50.0, 51.0, 57.0, 59.0, 63.0, 64.0, 69.0, 74.0, 79.0, 84.0, 85.0, 89.0, 89.0, 92.0]",23,13,10,0.5652173913043478,0.43478260869565216
222,2576181,"[1.0, 5.0, 9.0, 12.0, 24.0, 27.0, 31.0, 33.0, 38.0, 43.0, 48.0, 49.0, 50.0, 51.0, 57.0, 60.0, 63.0, 64.0, 69.0, 70.0, 81.0, 83.0, 85.0, 86.0]",24,15,9,0.625,0.375
223,2576182,"[12.0, 17.0, 19.0, 25.0, 31.0, 33.0, 39.0, 44.0, 61.0, 62.0, 65.0, 69.0, 80.0, 88.0, 90.0, 94.0]",16,8,8,0.5,0.5
224,2576183,"[1.0, 2.0, 4.0, 6.0, 15.0, 17.0, 25.0, 32.0, 34.0, 36.0, 40.0, 44.0, 46.0, 47.0, 49.0, 54.0, 59.0, 59.0, 61.0, 62.0, 66.0, 68.0, 69.0, 74.0, 80.0, 81.0, 82.0, 84.0, 86.0, 88.0, 89.0]",31,18,13,0.5806451612903226,0.41935483870967744
225,2576184,"[3.0, 7.0, 12.0, 36.0, 45.0, 54.0, 69.0, 72.0, 77.0, 81.0]",10,6,4,0.6,0.4
226,2576185,"[2.0, 3.0, 11.0, 20.0, 24.0, 28.0, 33.0, 40.0, 42.0, 47.0, 50.0, 51.0, 53.0, 55.0, 57.0, 59.0, 68.0, 73.0, 76.0, 78.0, 78.0, 82.0, 87.0, 94.0]",24,16,8,0.6666666666666666,0.3333333333333333
227,2576186,"[11.0, 12.0, 18.0, 19.0, 22.0, 30.0, 32.0, 33.0, 42.0, 44.0, 47.0, 58.0, 67.0, 80.0, 84.0, 85.0]",16,12,4,0.75,0.25
228,2576187,"[1.0, 4.0, 5.0, 7.0, 8.0, 10.0, 15.0, 16.0, 19.0, 20.0, 24.0, 30.0, 30.0, 35.0, 36.0, 38.0, 40.0, 45.0, 46.0, 47.0, 48.0, 47.0, 51.0, 54.0, 55.0, 57.0, 58.0, 61.0, 64.0, 66.0, 68.0, 70.0, 72.0, 73.0, 76.0, 77.0, 79.0, 81.0, 83.0, 84.0, 85.0, 85.0, 86.0, 89.0, 91.0, 94.0]",46,27,19,0.5869565217391305,0.41304347826086957
229,2576188,"[1.0, 3.0, 4.0, 9.0, 10.0, 16.0, 19.0, 22.0, 23.0, 27.0, 35.0, 38.0, 40.0, 41.0, 42.0, 49.0, 49.0, 54.0, 57.0, 60.0, 60.0, 62.0, 63.0, 68.0, 71.0, 72.0, 74.0, 76.0, 77.0, 80.0, 80.0, 83.0, 84.0, 84.0, 85.0, 92.0]",36,19,17,0.5277777777777778,0.4722222222222222
230,2576189,"[4.0, 5.0, 6.0, 8.0, 21.0, 23.0, 31.0, 32.0, 33.0, 34.0, 34.0, 35.0, 39.0, 44.0, 51.0, 52.0, 52.0, 59.0, 67.0, 67.0, 69.0, 75.0, 76.0, 78.0, 82.0, 83.0, 84.0, 85.0, 92.0, 93.0]",30,18,12,0.6,0.4
231,2576190,"[2.0, 10.0, 15.0, 24.0, 30.0, 38.0, 42.0, 45.0, 49.0, 52.0, 53.0, 69.0, 77.0, 85.0, 88.0, 91.0]",16,11,5,0.6875,0.3125
232,2576191,"[3.0, 4.0, 5.0, 11.0, 13.0, 16.0, 18.0, 19.0, 21.0, 23.0, 25.0, 28.0, 29.0, 34.0, 35.0, 42.0, 45.0, 46.0, 46.0, 49.0, 51.0, 52.0, 57.0, 60.0, 61.0, 63.0, 67.0, 75.0, 76.0, 78.0, 79.0, 87.0, 89.0, 91.0, 96.0, 98.0]",36,23,13,0.6388888888888888,0.3611111111111111
233,2576192,"[3.0, 9.0, 10.0, 12.0, 18.0, 21.0, 23.0, 25.0, 27.0, 28.0, 31.0, 32.0, 34.0, 37.0, 39.0, 40.0, 43.0, 45.0, 47.0, 55.0, 68.0, 73.0, 80.0, 88.0, 92.0, 92.0, 93.0]",27,20,7,0.7407407407407407,0.25925925925925924
234,2576193,"[2.0, 3.0, 6.0, 10.0, 12.0, 14.0, 15.0, 17.0, 22.0, 27.0, 38.0, 43.0, 44.0, 45.0, 46.0, 52.0, 53.0, 56.0, 59.0, 61.0, 62.0, 63.0, 64.0, 65.0, 69.0, 74.0, 76.0, 78.0, 80.0, 81.0, 84.0, 87.0, 92.0]",33,19,14,0.5757575757575758,0.42424242424242425
235,2576194,"[1.0, 6.0, 13.0, 19.0, 20.0, 24.0, 26.0, 28.0, 29.0, 40.0, 41.0, 42.0, 42.0, 45.0, 47.0, 50.0, 52.0, 54.0, 57.0, 58.0, 72.0, 76.0, 78.0, 83.0, 84.0, 90.0]",26,20,6,0.7692307692307693,0.23076923076923078
236,2576195,"[4.0, 6.0, 7.0, 12.0, 13.0, 22.0, 23.0, 24.0, 32.0, 35.0, 36.0, 36.0, 39.0, 39.0, 40.0, 45.0, 46.0, 48.0, 51.0, 54.0, 59.0, 67.0, 71.0, 80.0, 81.0, 82.0, 84.0, 87.0, 88.0, 89.0, 94.0]",31,21,10,0.6774193548387096,0.3225806451612903
237,2576196,"[7.0, 9.0, 14.0, 19.0, 24.0, 26.0, 30.0, 31.0, 37.0, 42.0, 44.0, 63.0, 65.0, 67.0, 67.0, 89.0]",16,11,5,0.6875,0.3125
238,2576197,"[3.0, 3.0, 6.0, 10.0, 12.0, 12.0, 14.0, 16.0, 16.0, 17.0, 23.0, 25.0, 29.0, 30.0, 33.0, 38.0, 39.0, 41.0, 42.0, 42.0, 43.0, 46.0, 50.0, 57.0, 60.0, 63.0, 68.0, 69.0, 71.0, 74.0, 80.0, 81.0, 89.0, 91.0]",34,24,10,0.7058823529411765,0.29411764705882354
239,2576198,"[4.0, 6.0, 7.0, 10.0, 23.0, 30.0, 34.0, 36.0, 38.0, 47.0, 47.0, 48.0, 50.0, 53.0, 54.0, 56.0, 56.0, 57.0, 60.0, 67.0, 68.0, 72.0, 73.0, 74.0, 77.0, 78.0, 80.0, 80.0, 85.0, 86.0]",30,18,12,0.6,0.4
240,2576199,"[3.0, 6.0, 8.0, 10.0, 11.0, 16.0, 29.0, 29.0, 36.0, 36.0, 42.0, 45.0, 46.0, 50.0, 51.0, 51.0, 55.0, 56.0, 57.0, 59.0, 61.0, 70.0, 72.0, 72.0, 78.0, 84.0, 86.0, 89.0, 90.0, 91.0, 92.0, 92.0, 93.0]",33,20,13,0.6060606060606061,0.3939393939393939
241,2576200,"[5.0, 14.0, 24.0, 25.0, 28.0, 29.0, 31.0, 34.0, 43.0, 45.0, 46.0, 52.0, 54.0, 55.0, 57.0, 58.0, 59.0, 62.0, 64.0, 66.0, 66.0, 72.0, 74.0, 80.0]",24,17,7,0.7083333333333334,0.2916666666666667
242,2576201,"[0.0, 2.0, 8.0, 10.0, 13.0, 14.0, 20.0, 24.0, 25.0, 31.0, 34.0, 35.0, 44.0, 47.0, 48.0, 53.0, 57.0, 63.0, 64.0, 69.0, 73.0, 74.0, 78.0, 81.0, 83.0, 84.0, 88.0, 88.0, 90.0]",29,17,12,0.5862068965517241,0.41379310344827586
243,2576202,"[11.0, 11.0, 16.0, 26.0, 33.0, 37.0, 38.0, 39.0, 50.0, 51.0, 58.0, 63.0, 70.0, 73.0, 74.0, 83.0, 90.0, 90.0]",18,11,7,0.6111111111111112,0.3888888888888889
244,2576203,"[2.0, 9.0, 11.0, 16.0, 16.0, 27.0, 37.0, 37.0, 40.0, 46.0, 47.0, 50.0, 53.0, 70.0, 72.0, 72.0, 83.0, 84.0, 88.0, 92.0]",20,13,7,0.65,0.35
245,2576204,"[11.0, 18.0, 19.0, 23.0, 23.0, 31.0, 38.0, 40.0, 46.0, 52.0, 53.0, 55.0, 56.0, 61.0, 64.0, 67.0, 72.0, 73.0, 79.0, 83.0, 88.0, 89.0, 92.0]",23,13,10,0.5652173913043478,0.43478260869565216
246,2576205,"[6.0, 9.0, 9.0, 12.0, 16.0, 17.0, 24.0, 25.0, 31.0, 32.0, 35.0, 46.0, 48.0, 51.0, 60.0, 62.0, 68.0, 76.0, 78.0, 83.0, 85.0, 88.0]",22,14,8,0.6363636363636364,0.36363636363636365
247,2576206,"[5.0, 6.0, 9.0, 16.0, 22.0, 22.0, 26.0, 30.0, 31.0, 33.0, 38.0, 40.0, 43.0, 45.0, 47.0, 53.0, 55.0, 61.0, 65.0, 66.0, 67.0, 71.0, 77.0, 78.0, 81.0, 82.0, 84.0, 92.0]",28,17,11,0.6071428571428571,0.39285714285714285
248,2576207,"[0.0, 3.0, 9.0, 11.0, 14.0, 15.0, 23.0, 28.0, 32.0, 33.0, 37.0, 41.0, 45.0, 46.0, 47.0, 52.0, 52.0, 54.0, 55.0, 58.0, 60.0, 62.0, 65.0, 72.0, 74.0, 76.0, 81.0, 83.0, 84.0, 86.0, 91.0, 92.0]",32,20,12,0.625,0.375
249,2576208,"[15.0, 16.0, 19.0, 33.0, 34.0, 38.0, 40.0, 41.0, 47.0, 54.0, 57.0, 64.0, 68.0, 76.0, 80.0, 81.0, 82.0, 82.0, 84.0, 89.0, 92.0, 93.0]",22,11,11,0.5,0.5
250,2576209,"[0.0, 2.0, 11.0, 14.0, 23.0, 25.0, 27.0, 33.0, 34.0, 36.0, 40.0, 40.0, 41.0, 47.0, 49.0, 52.0, 54.0, 56.0, 59.0, 60.0, 63.0, 65.0, 65.0, 71.0, 72.0, 77.0, 78.0, 81.0, 81.0, 83.0, 87.0, 87.0, 88.0, 91.0]",34,19,15,0.5588235294117647,0.4411764705882353
251,2576210,"[10.0, 16.0, 17.0, 18.0, 19.0, 20.0, 25.0, 29.0, 30.0, 39.0, 39.0, 41.0, 44.0, 45.0, 55.0, 59.0, 60.0, 67.0, 71.0, 72.0, 74.0, 75.0, 77.0, 78.0, 80.0, 81.0, 82.0, 86.0, 89.0]",29,16,13,0.5517241379310345,0.4482758620689655
252,2576211,"[1.0, 5.0, 7.0, 8.0, 11.0, 13.0, 15.0, 17.0, 21.0, 24.0, 25.0, 26.0, 27.0, 28.0, 30.0, 33.0, 36.0, 42.0, 43.0, 46.0, 46.0, 47.0, 47.0, 49.0, 52.0, 57.0, 62.0, 63.0, 66.0, 78.0, 81.0, 85.0, 89.0]",33,26,7,0.7878787878787878,0.21212121212121213
253,2576212,"[3.0, 6.0, 11.0, 15.0, 23.0, 26.0, 27.0, 29.0, 32.0, 34.0, 37.0, 38.0, 43.0, 50.0, 54.0, 57.0, 68.0, 74.0, 79.0, 80.0, 88.0, 90.0]",22,16,6,0.7272727272727273,0.2727272727272727
254,2576213,"[3.0, 9.0, 10.0, 10.0, 11.0, 17.0, 18.0, 20.0, 24.0, 27.0, 30.0, 32.0, 34.0, 36.0, 45.0, 48.0, 48.0, 53.0, 59.0, 61.0, 61.0, 70.0, 82.0, 85.0, 92.0]",25,19,6,0.76,0.24
255,2576214,"[1.0, 12.0, 21.0, 23.0, 24.0, 25.0, 35.0, 39.0, 42.0, 46.0, 46.0, 59.0, 65.0, 77.0, 87.0, 91.0, 93.0]",17,12,5,0.7058823529411765,0.29411764705882354
256,2576215,"[1.0, 12.0, 24.0, 30.0, 30.0, 34.0, 35.0, 47.0, 54.0, 63.0, 65.0, 71.0, 73.0, 74.0, 81.0, 89.0]",16,9,7,0.5625,0.4375
257,2576216,"[1.0, 2.0, 3.0, 6.0, 13.0, 14.0, 15.0, 17.0, 23.0, 28.0, 29.0, 31.0, 33.0, 38.0, 40.0, 41.0, 42.0, 42.0, 45.0, 49.0, 50.0, 55.0, 56.0, 61.0, 73.0, 80.0, 81.0, 84.0, 88.0, 90.0, 92.0, 93.0]",32,23,9,0.71875,0.28125
258,2576217,"[3.0, 4.0, 9.0, 10.0, 13.0, 16.0, 17.0, 18.0, 19.0, 21.0, 23.0, 26.0, 29.0, 33.0, 34.0, 35.0, 38.0, 39.0, 43.0, 47.0, 49.0, 50.0, 55.0, 58.0, 59.0, 61.0, 62.0, 65.0, 71.0, 79.0, 89.0]",31,25,6,0.8064516129032258,0.1935483870967742
259,2576218,"[0.0, 5.0, 8.0, 10.0, 11.0, 14.0, 16.0, 19.0, 21.0, 24.0, 26.0, 28.0, 51.0, 53.0, 55.0, 57.0, 61.0, 61.0, 63.0, 63.0, 65.0, 74.0, 76.0, 79.0, 80.0, 84.0, 85.0, 90.0, 93.0]",29,16,13,0.5517241379310345,0.4482758620689655
260,2576219,"[2.0, 7.0, 8.0, 10.0, 13.0, 14.0, 14.0, 18.0, 29.0, 34.0, 35.0, 36.0, 38.0, 42.0, 48.0, 49.0, 52.0, 56.0, 57.0, 58.0, 59.0, 62.0, 67.0, 71.0, 76.0, 77.0, 85.0, 87.0, 91.0, 92.0]",30,21,9,0.7,0.3
261,2576220,"[2.0, 4.0, 13.0, 14.0, 16.0, 18.0, 19.0, 22.0, 25.0, 26.0, 35.0, 40.0, 42.0, 50.0, 51.0, 52.0, 54.0, 55.0, 56.0, 57.0, 58.0, 61.0, 63.0, 64.0, 70.0, 71.0, 79.0, 82.0, 87.0, 94.0, 94.0, 95.0, 95.0]",33,21,12,0.6363636363636364,0.36363636363636365
262,2576221,"[2.0, 17.0, 21.0, 22.0, 24.0, 30.0, 33.0, 35.0, 37.0, 40.0, 43.0, 46.0, 56.0, 58.0, 61.0, 66.0, 69.0, 70.0, 71.0, 72.0, 73.0, 75.0, 76.0, 81.0, 84.0]",25,14,11,0.56,0.44
263,2576222,"[1.0, 20.0, 25.0, 25.0, 26.0, 27.0, 27.0, 29.0, 30.0, 35.0, 37.0, 38.0, 41.0, 42.0, 43.0, 51.0, 52.0, 56.0, 57.0, 58.0, 64.0, 66.0, 66.0, 66.0, 69.0, 73.0, 75.0, 77.0, 83.0, 92.0]",30,20,10,0.6666666666666666,0.3333333333333333
264,2576223,"[1.0, 14.0, 16.0, 27.0, 29.0, 30.0, 31.0, 35.0, 38.0, 39.0, 41.0, 43.0, 44.0, 45.0, 47.0, 51.0, 52.0, 54.0, 67.0, 68.0, 72.0, 75.0, 85.0, 86.0, 88.0, 89.0, 92.0]",27,18,9,0.6666666666666666,0.3333333333333333
265,2576224,"[3.0, 5.0, 9.0, 13.0, 14.0, 20.0, 23.0, 29.0, 35.0, 53.0, 57.0, 58.0, 59.0, 62.0, 65.0, 70.0, 76.0, 82.0]",18,13,5,0.7222222222222222,0.2777777777777778
266,2576225,"[2.0, 8.0, 10.0, 13.0, 14.0, 17.0, 17.0, 26.0, 28.0, 30.0, 34.0, 35.0, 40.0, 41.0, 47.0, 46.0, 51.0, 56.0, 59.0, 64.0, 68.0, 69.0, 71.0, 75.0, 81.0, 83.0, 85.0, 87.0]",28,19,9,0.6785714285714286,0.32142857142857145
267,2576226,"[18.0, 20.0, 33.0, 35.0, 38.0, 45.0, 47.0, 48.0, 54.0, 54.0, 54.0, 75.0, 77.0, 81.0, 83.0, 85.0, 88.0]",17,11,6,0.6470588235294118,0.35294117647058826
268,2576227,"[3.0, 11.0, 12.0, 20.0, 32.0, 41.0, 42.0, 45.0, 47.0, 50.0, 52.0, 54.0, 65.0, 75.0, 78.0, 81.0, 81.0, 82.0, 89.0, 89.0, 91.0, 91.0]",22,12,10,0.5454545454545454,0.45454545454545453
269,2576228,"[4.0, 4.0, 13.0, 14.0, 21.0, 22.0, 26.0, 27.0, 31.0, 37.0, 38.0, 39.0, 41.0, 44.0, 47.0, 48.0, 55.0, 61.0, 75.0, 76.0, 83.0, 84.0, 86.0, 88.0, 90.0, 94.0]",26,17,9,0.6538461538461539,0.34615384615384615
270,2576229,"[4.0, 6.0, 10.0, 12.0, 19.0, 23.0, 24.0, 25.0, 42.0, 43.0, 45.0, 46.0, 54.0, 57.0, 58.0, 66.0, 67.0, 69.0, 79.0, 86.0, 91.0, 91.0]",22,15,7,0.6818181818181818,0.3181818181818182
271,2576230,"[18.0, 19.0, 34.0, 42.0, 48.0, 52.0, 54.0, 62.0, 65.0, 66.0, 67.0, 71.0, 75.0, 79.0, 79.0, 84.0, 89.0, 91.0, 92.0]",19,7,12,0.3684210526315789,0.631578947368421
272,2576231,"[4.0, 13.0, 14.0, 15.0, 22.0, 23.0, 26.0, 28.0, 28.0, 29.0, 32.0, 39.0, 40.0, 54.0, 59.0, 62.0, 64.0, 66.0, 72.0, 73.0, 74.0, 78.0, 82.0, 82.0, 84.0, 84.0, 88.0, 91.0, 91.0, 92.0, 94.0]",31,15,16,0.4838709677419355,0.5161290322580645
273,2576232,"[4.0, 7.0, 15.0, 27.0, 29.0, 32.0, 32.0, 34.0, 36.0, 40.0, 42.0, 43.0, 48.0, 49.0, 50.0, 52.0, 53.0, 60.0, 62.0, 69.0, 77.0, 84.0, 86.0, 87.0]",24,17,7,0.7083333333333334,0.2916666666666667
274,2576233,"[9.0, 25.0, 29.0, 34.0, 44.0, 52.0, 62.0, 69.0, 70.0, 78.0, 82.0, 83.0, 89.0, 93.0]",14,6,8,0.42857142857142855,0.5714285714285714
275,2576234,"[1.0, 4.0, 13.0, 17.0, 35.0, 38.0, 47.0, 53.0, 56.0, 60.0, 61.0, 64.0, 72.0, 74.0, 81.0, 84.0, 88.0, 89.0]",18,9,9,0.5,0.5
276,2576235,"[3.0, 7.0, 11.0, 12.0, 13.0, 15.0, 21.0, 23.0, 26.0, 26.0, 29.0, 30.0, 31.0, 35.0, 40.0, 41.0, 44.0, 45.0, 45.0, 46.0, 50.0, 52.0, 54.0, 55.0, 56.0, 58.0, 62.0, 63.0, 65.0, 66.0, 70.0, 72.0, 78.0, 86.0, 91.0, 94.0]",36,26,10,0.7222222222222222,0.2777777777777778
277,2576236,"[5.0, 7.0, 7.0, 11.0, 16.0, 19.0, 29.0, 34.0, 38.0, 43.0, 47.0, 49.0, 50.0, 51.0, 55.0, 57.0, 59.0, 65.0, 66.0, 68.0, 72.0, 78.0, 80.0, 82.0, 88.0, 88.0, 92.0]",27,17,10,0.6296296296296297,0.37037037037037035
278,2576237,"[8.0, 10.0, 15.0, 20.0, 26.0, 26.0, 28.0, 31.0, 35.0, 38.0, 40.0, 43.0, 45.0, 48.0, 54.0, 54.0, 58.0, 62.0, 65.0, 66.0, 71.0, 71.0, 72.0, 74.0, 76.0, 77.0, 80.0, 81.0, 87.0, 87.0]",30,17,13,0.5666666666666667,0.43333333333333335
279,2576238,"[1.0, 10.0, 19.0, 23.0, 25.0, 30.0, 36.0, 42.0, 46.0, 52.0, 54.0, 60.0, 62.0, 65.0, 87.0, 90.0]",16,11,5,0.6875,0.3125
280,2576239,"[9.0, 16.0, 20.0, 22.0, 25.0, 26.0, 32.0, 38.0, 39.0, 43.0, 46.0, 50.0, 45.0, 50.0, 51.0, 52.0, 53.0, 59.0, 61.0, 72.0, 72.0, 73.0, 78.0, 83.0]",24,18,6,0.75,0.25
281,2576240,"[2.0, 12.0, 13.0, 18.0, 25.0, 28.0, 28.0, 33.0, 42.0, 55.0, 57.0, 61.0, 64.0, 69.0, 78.0, 84.0, 86.0]",17,11,6,0.6470588235294118,0.35294117647058826
282,2576241,"[10.0, 15.0, 21.0, 28.0, 37.0, 48.0, 49.0, 61.0, 62.0, 65.0, 70.0, 71.0, 76.0, 77.0, 81.0, 83.0, 93.0, 98.0]",18,7,11,0.3888888888888889,0.6111111111111112
283,2576242,"[2.0, 17.0, 21.0, 23.0, 24.0, 28.0, 33.0, 37.0, 39.0, 42.0, 43.0, 44.0, 45.0, 45.0, 46.0, 47.0, 48.0, 49.0, 55.0, 59.0, 60.0, 64.0, 67.0, 72.0, 73.0, 74.0, 77.0, 79.0, 90.0, 93.0, 94.0]",31,20,11,0.6451612903225806,0.3548387096774194
284,2576243,"[1.0, 10.0, 11.0, 15.0, 21.0, 22.0, 25.0, 26.0, 30.0, 31.0, 33.0, 34.0, 44.0, 47.0, 48.0, 49.0, 50.0, 46.0, 55.0, 57.0, 64.0, 66.0, 68.0, 70.0, 71.0, 74.0, 76.0, 85.0, 89.0, 91.0]",30,20,10,0.6666666666666666,0.3333333333333333
285,2576244,"[18.0, 20.0, 27.0, 30.0, 46.0, 50.0, 51.0, 55.0, 57.0, 59.0, 60.0, 64.0, 75.0, 76.0, 81.0, 88.0, 89.0, 91.0]",18,10,8,0.5555555555555556,0.4444444444444444
286,2576245,"[5.0, 11.0, 14.0, 16.0, 19.0, 28.0, 35.0, 36.0, 43.0, 46.0, 46.0, 47.0, 53.0, 67.0, 72.0, 77.0, 80.0]",17,13,4,0.7647058823529411,0.23529411764705882
287,2576246,"[1.0, 9.0, 14.0, 14.0, 18.0, 21.0, 23.0, 25.0, 31.0, 32.0, 39.0, 39.0, 43.0, 46.0, 53.0, 56.0, 57.0, 59.0, 61.0, 64.0, 65.0, 67.0, 68.0, 69.0, 69.0, 76.0, 78.0, 78.0, 79.0, 85.0, 85.0, 90.0, 93.0]",33,18,15,0.5454545454545454,0.45454545454545453
288,2576247,"[1.0, 2.0, 4.0, 7.0, 15.0, 26.0, 28.0, 29.0, 46.0, 47.0, 47.0, 48.0, 55.0, 69.0, 72.0, 77.0, 78.0, 81.0, 84.0, 85.0, 93.0]",21,13,8,0.6190476190476191,0.38095238095238093
289,2576248,"[0.0, 1.0, 13.0, 14.0, 22.0, 23.0, 25.0, 26.0, 29.0, 33.0, 34.0, 36.0, 51.0, 55.0, 56.0, 58.0, 62.0, 63.0, 65.0, 65.0, 68.0, 71.0, 71.0, 77.0, 78.0, 82.0, 85.0, 87.0, 88.0]",29,16,13,0.5517241379310345,0.4482758620689655
290,2576249,"[1.0, 3.0, 4.0, 7.0, 13.0, 20.0, 21.0, 28.0, 30.0, 34.0, 37.0, 37.0, 38.0, 42.0, 45.0, 47.0, 47.0, 54.0, 63.0, 67.0, 78.0, 81.0, 85.0, 87.0, 88.0, 90.0, 91.0]",27,18,9,0.6666666666666666,0.3333333333333333
291,2576250,"[1.0, 7.0, 15.0, 16.0, 18.0, 18.0, 22.0, 26.0, 29.0, 31.0, 31.0, 38.0, 41.0, 42.0, 45.0, 48.0, 52.0, 52.0, 56.0, 56.0, 57.0, 64.0, 65.0, 68.0, 71.0, 77.0, 78.0, 79.0, 80.0, 88.0, 93.0]",31,21,10,0.6774193548387096,0.3225806451612903
292,2576251,"[2.0, 3.0, 4.0, 5.0, 10.0, 17.0, 19.0, 21.0, 31.0, 34.0, 36.0, 45.0, 47.0, 52.0, 58.0, 60.0, 63.0, 77.0, 90.0]",19,15,4,0.7894736842105263,0.21052631578947367
293,2576252,"[1.0, 3.0, 10.0, 16.0, 17.0, 21.0, 31.0, 33.0, 37.0, 37.0, 38.0, 38.0, 40.0, 45.0, 45.0, 48.0, 50.0, 51.0, 60.0, 66.0, 70.0, 71.0, 81.0, 82.0, 86.0, 88.0]",26,18,8,0.6923076923076923,0.3076923076923077
294,2576253,"[0.0, 7.0, 15.0, 21.0, 23.0, 26.0, 30.0, 31.0, 32.0, 33.0, 34.0, 40.0, 41.0, 42.0, 43.0, 46.0, 47.0, 54.0, 58.0, 65.0, 74.0, 76.0, 79.0, 84.0, 85.0, 87.0, 88.0]",27,19,8,0.7037037037037037,0.2962962962962963
295,2576254,"[2.0, 8.0, 20.0, 24.0, 26.0, 27.0, 29.0, 35.0, 36.0, 41.0, 47.0, 49.0, 51.0, 59.0, 60.0, 66.0, 66.0, 71.0, 72.0, 75.0, 79.0, 80.0, 82.0, 86.0]",24,14,10,0.5833333333333334,0.4166666666666667
296,2576255,"[10.0, 14.0, 22.0, 25.0, 28.0, 29.0, 31.0, 33.0, 38.0, 45.0, 51.0, 52.0, 52.0, 53.0, 55.0, 56.0, 57.0, 60.0, 62.0, 65.0, 72.0, 84.0, 85.0, 88.0, 95.0]",25,17,8,0.68,0.32
297,2576256,"[1.0, 2.0, 4.0, 7.0, 9.0, 12.0, 13.0, 13.0, 16.0, 17.0, 19.0, 20.0, 21.0, 24.0, 30.0, 33.0, 35.0, 37.0, 39.0, 47.0, 46.0, 49.0, 52.0, 52.0, 56.0, 58.0, 60.0, 61.0, 63.0, 64.0, 69.0, 70.0, 71.0, 72.0, 73.0, 81.0, 87.0, 88.0, 91.0, 93.0]",40,26,14,0.65,0.35
298,2576257,"[2.0, 2.0, 10.0, 11.0, 13.0, 13.0, 14.0, 20.0, 25.0, 29.0, 36.0, 41.0, 42.0, 43.0, 45.0, 48.0, 50.0, 53.0, 54.0, 55.0, 70.0, 71.0, 73.0, 78.0, 82.0, 89.0]",26,20,6,0.7692307692307693,0.23076923076923078
299,2576258,"[6.0, 8.0, 11.0, 15.0, 21.0, 28.0, 35.0, 38.0, 40.0, 42.0, 47.0, 48.0, 49.0, 55.0, 56.0, 62.0, 67.0, 72.0, 85.0, 86.0, 88.0]",21,15,6,0.7142857142857143,0.2857142857142857
300,2576259,"[4.0, 5.0, 6.0, 10.0, 10.0, 13.0, 14.0, 19.0, 23.0, 27.0, 28.0, 29.0, 33.0, 37.0, 40.0, 41.0, 43.0, 54.0, 56.0, 57.0, 61.0, 65.0, 68.0, 71.0, 72.0, 75.0, 75.0, 77.0, 78.0, 80.0, 81.0, 83.0, 84.0, 85.0, 91.0, 92.0]",36,20,16,0.5555555555555556,0.4444444444444444
301,2576260,"[5.0, 9.0, 9.0, 12.0, 16.0, 17.0, 18.0, 20.0, 28.0, 30.0, 32.0, 37.0, 39.0, 41.0, 42.0, 44.0, 45.0, 47.0, 55.0, 56.0, 57.0, 58.0, 61.0, 62.0, 63.0, 65.0, 73.0, 73.0, 76.0, 80.0, 82.0, 82.0, 83.0, 85.0, 86.0, 86.0, 88.0, 90.0]",38,22,16,0.5789473684210527,0.42105263157894735
302,2576261,"[6.0, 8.0, 15.0, 18.0, 19.0, 22.0, 25.0, 26.0, 28.0, 29.0, 31.0, 32.0, 42.0, 44.0, 46.0, 48.0, 49.0, 54.0, 59.0, 62.0, 68.0, 72.0, 73.0, 78.0, 78.0, 81.0, 82.0, 84.0, 86.0, 88.0, 89.0]",31,19,12,0.6129032258064516,0.3870967741935484
303,2576262,"[9.0, 10.0, 11.0, 12.0, 17.0, 25.0, 33.0, 44.0, 49.0, 53.0, 54.0, 55.0, 60.0, 70.0, 72.0, 72.0, 76.0, 77.0, 87.0, 90.0, 90.0]",21,12,9,0.5714285714285714,0.42857142857142855
304,2576263,"[5.0, 6.0, 13.0, 18.0, 20.0, 32.0, 43.0, 46.0, 48.0, 49.0, 50.0, 57.0, 60.0, 74.0, 85.0, 91.0, 95.0, 95.0]",18,12,6,0.6666666666666666,0.3333333333333333
305,2576264,"[2.0, 2.0, 8.0, 10.0, 14.0, 18.0, 23.0, 24.0, 29.0, 41.0, 43.0, 45.0, 45.0, 46.0, 53.0, 55.0, 70.0, 71.0, 72.0, 74.0, 81.0, 87.0, 91.0]",23,16,7,0.6956521739130435,0.30434782608695654
306,2576265,"[6.0, 16.0, 20.0, 22.0, 24.0, 33.0, 37.0, 39.0, 46.0, 49.0, 50.0, 53.0, 57.0, 59.0, 60.0, 61.0, 67.0, 76.0, 79.0, 88.0, 89.0, 91.0]",22,14,8,0.6363636363636364,0.36363636363636365
307,2576266,"[2.0, 4.0, 23.0, 25.0, 27.0, 28.0, 29.0, 35.0, 36.0, 37.0, 42.0, 44.0, 50.0, 54.0, 57.0, 63.0, 73.0, 79.0, 80.0, 89.0, 91.0]",21,15,6,0.7142857142857143,0.2857142857142857
308,2576267,"[5.0, 6.0, 28.0, 31.0, 34.0, 47.0, 49.0, 56.0, 64.0, 74.0, 82.0, 83.0, 84.0, 86.0, 87.0, 89.0, 94.0]",17,8,9,0.47058823529411764,0.5294117647058824
309,2576268,"[14.0, 17.0, 19.0, 21.0, 22.0, 27.0, 28.0, 36.0, 38.0, 40.0, 46.0, 47.0, 48.0, 53.0, 54.0, 61.0, 62.0, 68.0, 73.0, 74.0, 78.0, 80.0, 80.0, 88.0, 90.0, 92.0, 93.0]",27,15,12,0.5555555555555556,0.4444444444444444
310,2576269,"[1.0, 3.0, 4.0, 6.0, 9.0, 11.0, 15.0, 18.0, 22.0, 25.0, 26.0, 26.0, 31.0, 32.0, 40.0, 44.0, 45.0, 47.0, 51.0, 45.0, 49.0, 52.0, 54.0, 56.0, 57.0, 57.0, 60.0, 65.0, 66.0, 66.0, 70.0, 75.0, 77.0, 79.0, 85.0, 86.0, 95.0]",37,26,11,0.7027027027027027,0.2972972972972973
311,2576270,"[4.0, 6.0, 8.0, 9.0, 10.0, 13.0, 13.0, 17.0, 29.0, 31.0, 35.0, 39.0, 42.0, 43.0, 46.0, 46.0, 47.0, 52.0, 55.0, 58.0, 61.0, 64.0, 65.0, 66.0, 68.0, 71.0, 72.0, 75.0, 82.0, 83.0, 85.0, 87.0, 89.0, 89.0, 90.0, 92.0]",36,20,16,0.5555555555555556,0.4444444444444444
312,2576271,"[3.0, 4.0, 9.0, 13.0, 16.0, 19.0, 21.0, 22.0, 22.0, 26.0, 29.0, 38.0, 41.0, 50.0, 53.0, 60.0, 61.0, 63.0, 64.0, 65.0, 66.0, 69.0, 72.0, 76.0, 79.0, 82.0, 83.0, 84.0, 85.0, 86.0, 89.0, 93.0]",32,15,17,0.46875,0.53125
313,2576272,"[3.0, 9.0, 16.0, 19.0, 24.0, 31.0, 31.0, 36.0, 39.0, 40.0, 54.0, 61.0, 62.0, 64.0, 68.0, 74.0, 75.0, 79.0, 81.0, 90.0]",20,11,9,0.55,0.45
314,2576273,"[4.0, 10.0, 24.0, 36.0, 43.0, 45.0, 46.0, 54.0, 62.0, 63.0, 69.0, 70.0, 86.0, 88.0, 89.0, 90.0, 90.0]",17,8,9,0.47058823529411764,0.5294117647058824
315,2576274,"[2.0, 7.0, 9.0, 10.0, 19.0, 22.0, 28.0, 29.0, 30.0, 31.0, 34.0, 34.0, 35.0, 35.0, 39.0, 41.0, 43.0, 44.0, 46.0, 49.0, 54.0, 59.0, 62.0, 69.0, 76.0, 79.0, 85.0]",27,22,5,0.8148148148148148,0.18518518518518517
316,2576275,"[4.0, 8.0, 13.0, 14.0, 21.0, 25.0, 26.0, 32.0, 42.0, 44.0, 44.0, 52.0, 53.0, 54.0, 63.0]",15,14,1,0.9333333333333333,0.06666666666666667
317,2576276,"[3.0, 16.0, 20.0, 23.0, 28.0, 29.0, 38.0, 43.0, 45.0, 46.0, 46.0, 55.0, 58.0, 59.0, 64.0, 68.0, 73.0, 79.0, 81.0, 83.0, 88.0, 92.0]",22,14,8,0.6363636363636364,0.36363636363636365
318,2576277,"[5.0, 8.0, 15.0, 16.0, 20.0, 30.0, 33.0, 35.0, 36.0, 39.0, 45.0, 46.0, 50.0, 51.0, 53.0, 57.0, 67.0, 73.0, 78.0, 84.0, 86.0, 87.0, 88.0, 89.0, 92.0, 92.0, 92.0]",27,16,11,0.5925925925925926,0.4074074074074074
319,2576278,"[0.0, 3.0, 7.0, 12.0, 16.0, 20.0, 22.0, 23.0, 25.0, 26.0, 33.0, 35.0, 37.0, 42.0, 47.0, 48.0, 59.0, 68.0, 71.0, 72.0, 78.0, 89.0, 89.0, 90.0, 90.0, 90.0, 92.0]",27,17,10,0.6296296296296297,0.37037037037037035
320,2576279,"[2.0, 3.0, 3.0, 4.0, 6.0, 14.0, 15.0, 15.0, 16.0, 17.0, 24.0, 27.0, 30.0, 30.0, 34.0, 39.0, 40.0, 45.0, 50.0, 54.0, 55.0, 57.0, 60.0, 61.0, 63.0, 64.0, 69.0, 70.0, 74.0, 75.0, 81.0, 83.0, 86.0, 91.0, 93.0]",35,22,13,0.6285714285714286,0.37142857142857144
321,2576280,"[2.0, 5.0, 7.0, 11.0, 17.0, 18.0, 20.0, 22.0, 30.0, 37.0, 38.0, 40.0, 46.0, 46.0, 53.0, 54.0, 65.0, 67.0, 71.0, 80.0, 81.0, 83.0, 84.0, 92.0]",24,16,8,0.6666666666666666,0.3333333333333333
322,2576281,"[2.0, 4.0, 11.0, 16.0, 24.0, 25.0, 26.0, 31.0, 50.0, 51.0, 57.0, 62.0, 69.0, 75.0, 79.0, 86.0, 88.0]",17,11,6,0.6470588235294118,0.35294117647058826
323,2576282,"[1.0, 2.0, 3.0, 4.0, 10.0, 11.0, 14.0, 16.0, 25.0, 28.0, 33.0, 34.0, 37.0, 40.0, 43.0, 45.0, 47.0, 52.0, 54.0, 55.0, 57.0, 62.0, 66.0, 67.0, 68.0, 69.0, 73.0, 74.0, 77.0, 78.0, 82.0, 86.0, 87.0, 91.0, 92.0, 93.0]",36,21,15,0.5833333333333334,0.4166666666666667
324,2576283,"[4.0, 5.0, 8.0, 11.0, 16.0, 18.0, 24.0, 27.0, 34.0, 38.0, 46.0, 48.0, 53.0, 63.0, 65.0, 65.0, 80.0, 86.0, 92.0, 93.0]",20,13,7,0.65,0.35
325,2576284,"[4.0, 8.0, 22.0, 35.0, 42.0, 44.0, 46.0, 50.0, 51.0, 56.0, 57.0, 67.0, 73.0, 73.0, 80.0, 83.0, 85.0, 86.0, 87.0, 91.0, 92.0]",21,11,10,0.5238095238095238,0.47619047619047616
326,2576285,"[2.0, 3.0, 4.0, 6.0, 13.0, 17.0, 18.0, 19.0, 27.0, 27.0, 29.0, 35.0, 38.0, 42.0, 48.0, 46.0, 50.0, 52.0, 53.0, 64.0, 67.0, 74.0, 76.0, 78.0, 79.0, 82.0, 83.0, 84.0, 88.0, 93.0, 94.0, 95.0, 96.0, 97.0]",34,19,15,0.5588235294117647,0.4411764705882353
327,2576286,"[1.0, 2.0, 5.0, 5.0, 6.0, 14.0, 15.0, 16.0, 18.0, 21.0, 24.0, 25.0, 26.0, 30.0, 39.0, 40.0, 42.0, 43.0, 44.0, 46.0, 49.0, 61.0, 67.0, 71.0, 73.0, 74.0, 74.0, 75.0, 76.0, 78.0, 78.0, 87.0, 92.0, 93.0, 95.0, 96.0]",36,21,15,0.5833333333333334,0.4166666666666667
328,2576287,"[1.0, 2.0, 7.0, 11.0, 13.0, 19.0, 20.0, 21.0, 22.0, 25.0, 26.0, 31.0, 39.0, 40.0, 43.0, 44.0, 46.0, 51.0, 52.0, 53.0, 55.0, 56.0, 57.0, 60.0, 65.0, 69.0, 70.0, 74.0, 75.0, 80.0, 82.0, 89.0, 93.0]",33,23,10,0.696969696969697,0.30303030303030304
329,2576288,"[8.0, 12.0, 13.0, 19.0, 24.0, 28.0, 29.0, 30.0, 31.0, 32.0, 34.0, 57.0, 59.0, 61.0, 64.0, 67.0, 71.0, 83.0, 84.0, 89.0, 90.0, 90.0, 92.0]",23,13,10,0.5652173913043478,0.43478260869565216
330,2576289,"[0.0, 6.0, 13.0, 16.0, 17.0, 19.0, 22.0, 30.0, 38.0, 46.0, 47.0, 50.0, 58.0, 59.0, 73.0, 74.0, 79.0, 82.0, 83.0, 85.0, 92.0, 94.0, 94.0]",23,14,9,0.6086956521739131,0.391304347826087
331,2576290,"[2.0, 3.0, 9.0, 11.0, 17.0, 22.0, 24.0, 30.0, 34.0, 35.0, 37.0, 37.0, 39.0, 48.0, 50.0, 51.0, 53.0, 55.0, 60.0, 62.0, 74.0, 76.0, 77.0, 84.0, 85.0, 86.0, 86.0, 93.0, 94.0]",29,18,11,0.6206896551724138,0.3793103448275862
332,2576291,"[1.0, 8.0, 9.0, 13.0, 13.0, 15.0, 20.0, 21.0, 25.0, 28.0, 37.0, 40.0, 41.0, 45.0, 48.0, 54.0, 56.0, 57.0, 62.0, 65.0, 66.0, 67.0, 69.0, 72.0, 74.0, 75.0, 76.0, 89.0]",28,18,10,0.6428571428571429,0.35714285714285715
333,2576292,"[6.0, 8.0, 10.0, 13.0, 18.0, 19.0, 20.0, 20.0, 21.0, 22.0, 25.0, 28.0, 28.0, 29.0, 31.0, 33.0, 35.0, 36.0, 37.0, 39.0, 42.0, 43.0, 46.0, 47.0, 48.0, 51.0, 52.0, 53.0, 58.0, 63.0, 71.0, 73.0, 74.0, 75.0, 78.0, 85.0, 86.0, 87.0, 88.0, 89.0, 93.0, 94.0, 95.0]",43,29,14,0.6744186046511628,0.32558139534883723
334,2576293,"[0.0, 1.0, 3.0, 7.0, 10.0, 13.0, 18.0, 27.0, 29.0, 32.0, 34.0, 35.0, 41.0, 46.0, 53.0, 57.0, 62.0, 63.0, 67.0, 70.0, 75.0, 79.0, 87.0, 91.0, 94.0]",25,16,9,0.64,0.36
335,2576294,"[3.0, 11.0, 15.0, 16.0, 24.0, 35.0, 35.0, 40.0, 40.0, 46.0, 47.0, 48.0, 53.0, 57.0, 65.0, 70.0, 71.0, 74.0, 77.0, 88.0]",20,14,6,0.7,0.3
336,2576295,"[2.0, 9.0, 9.0, 15.0, 15.0, 18.0, 27.0, 33.0, 34.0, 38.0, 41.0, 42.0, 44.0, 47.0, 56.0, 63.0, 64.0, 66.0, 67.0, 69.0, 78.0, 79.0, 81.0, 84.0, 88.0, 91.0, 93.0]",27,15,12,0.5555555555555556,0.4444444444444444
337,2576296,"[4.0, 8.0, 10.0, 11.0, 15.0, 17.0, 27.0, 30.0, 31.0, 39.0, 40.0, 41.0, 42.0, 44.0, 51.0, 52.0, 57.0, 72.0, 81.0, 86.0, 89.0, 91.0]",22,17,5,0.7727272727272727,0.22727272727272727
338,2576297,"[1.0, 3.0, 5.0, 10.0, 15.0, 16.0, 18.0, 20.0, 24.0, 25.0, 48.0, 49.0, 53.0, 55.0, 62.0, 63.0, 65.0, 66.0, 79.0, 80.0]",20,14,6,0.7,0.3
339,2576298,"[2.0, 2.0, 9.0, 9.0, 12.0, 13.0, 15.0, 20.0, 24.0, 31.0, 32.0, 38.0, 39.0, 40.0, 45.0, 49.0, 51.0, 54.0, 58.0, 63.0, 66.0, 72.0, 73.0, 75.0, 76.0, 79.0, 80.0, 82.0, 83.0, 86.0, 88.0, 88.0, 89.0, 91.0, 92.0, 92.0, 92.0, 94.0]",38,19,19,0.5,0.5
340,2576299,"[1.0, 10.0, 13.0, 18.0, 18.0, 19.0, 28.0, 30.0, 36.0, 38.0, 39.0, 42.0, 44.0, 46.0, 51.0, 53.0, 54.0, 55.0, 56.0, 61.0, 73.0, 77.0, 80.0, 80.0, 83.0, 83.0, 84.0]",27,19,8,0.7037037037037037,0.2962962962962963
341,2576300,"[5.0, 6.0, 8.0, 10.0, 12.0, 21.0, 22.0, 24.0, 27.0, 28.0, 29.0, 37.0, 45.0, 46.0, 51.0, 55.0, 64.0, 80.0, 84.0, 86.0, 90.0, 91.0, 91.0]",23,16,7,0.6956521739130435,0.30434782608695654
342,2576301,"[5.0, 9.0, 13.0, 21.0, 21.0, 26.0, 27.0, 31.0, 37.0, 42.0, 47.0, 49.0, 52.0, 53.0, 65.0, 70.0, 72.0, 80.0, 88.0]",19,14,5,0.7368421052631579,0.2631578947368421
343,2576302,"[1.0, 4.0, 15.0, 20.0, 28.0, 29.0, 39.0, 44.0, 47.0, 49.0, 51.0, 54.0, 55.0, 55.0, 57.0, 57.0, 61.0, 68.0, 68.0, 73.0, 76.0, 85.0, 88.0, 88.0]",24,16,8,0.6666666666666666,0.3333333333333333
344,2576303,"[12.0, 15.0, 21.0, 26.0, 30.0, 31.0, 33.0, 39.0, 42.0, 42.0, 45.0, 46.0, 48.0, 54.0, 57.0, 59.0, 63.0, 66.0, 73.0, 75.0, 79.0, 79.0, 81.0, 82.0, 87.0, 89.0, 91.0, 92.0, 93.0]",29,16,13,0.5517241379310345,0.4482758620689655
345,2576304,"[6.0, 14.0, 20.0, 21.0, 21.0, 23.0, 27.0, 32.0, 37.0, 44.0, 47.0, 47.0, 48.0, 51.0, 56.0, 57.0, 62.0, 78.0, 78.0, 80.0, 81.0, 83.0, 85.0, 87.0, 89.0, 90.0, 92.0]",27,16,11,0.5925925925925926,0.4074074074074074
346,2576305,"[0.0, 5.0, 10.0, 13.0, 18.0, 19.0, 24.0, 27.0, 31.0, 32.0, 33.0, 36.0, 37.0, 39.0, 45.0, 47.0, 48.0, 53.0, 59.0, 72.0, 75.0, 77.0, 78.0, 79.0, 81.0, 82.0, 86.0, 88.0, 90.0]",29,19,10,0.6551724137931034,0.3448275862068966
347,2576306,"[1.0, 5.0, 8.0, 17.0, 17.0, 18.0, 22.0, 32.0, 36.0, 42.0, 43.0, 44.0, 60.0, 63.0, 67.0, 67.0, 73.0, 77.0, 79.0, 81.0, 82.0, 85.0, 91.0]",23,12,11,0.5217391304347826,0.4782608695652174
348,2576307,"[0.0, 2.0, 5.0, 6.0, 11.0, 14.0, 15.0, 22.0, 24.0, 25.0, 26.0, 27.0, 34.0, 36.0, 40.0, 42.0, 43.0, 45.0, 46.0, 48.0, 52.0, 53.0, 55.0, 66.0, 66.0, 72.0, 74.0, 77.0, 85.0, 86.0]",30,23,7,0.7666666666666667,0.23333333333333334
349,2576308,"[0.0, 1.0, 2.0, 3.0, 4.0, 6.0, 8.0, 11.0, 25.0, 26.0, 30.0, 34.0, 34.0, 36.0, 39.0, 44.0, 48.0, 46.0, 47.0, 47.0, 51.0, 53.0, 56.0, 64.0, 65.0, 69.0, 71.0, 80.0, 85.0, 88.0, 95.0]",31,23,8,0.7419354838709677,0.25806451612903225
350,2576309,"[3.0, 5.0, 11.0, 21.0, 30.0, 38.0, 42.0, 48.0, 67.0, 71.0, 74.0, 83.0, 89.0, 91.0]",14,8,6,0.5714285714285714,0.42857142857142855
351,2576310,"[1.0, 3.0, 5.0, 7.0, 12.0, 14.0, 15.0, 18.0, 18.0, 20.0, 34.0, 43.0, 43.0, 44.0, 45.0, 50.0, 52.0, 55.0, 57.0, 61.0, 62.0, 65.0, 66.0, 68.0, 70.0, 73.0, 75.0, 75.0, 78.0, 79.0, 79.0, 80.0, 83.0, 85.0, 87.0, 90.0, 91.0]",37,19,18,0.5135135135135135,0.4864864864864865
352,2576311,"[4.0, 4.0, 8.0, 9.0, 13.0, 14.0, 18.0, 26.0, 31.0, 31.0, 41.0, 41.0, 49.0, 57.0, 58.0, 60.0, 61.0, 62.0, 67.0, 78.0, 80.0, 84.0, 89.0, 89.0, 90.0]",25,15,10,0.6,0.4
353,2576312,"[1.0, 4.0, 7.0, 11.0, 13.0, 16.0, 24.0, 25.0, 29.0, 32.0, 39.0, 41.0, 43.0, 45.0, 46.0, 47.0, 51.0, 52.0, 53.0, 54.0, 60.0, 65.0, 67.0, 70.0, 77.0, 79.0, 81.0, 85.0, 88.0, 90.0, 94.0]",31,20,11,0.6451612903225806,0.3548387096774194
354,2576313,"[2.0, 2.0, 13.0, 19.0, 22.0, 27.0, 28.0, 34.0, 37.0, 39.0, 47.0, 50.0, 52.0, 54.0, 56.0, 60.0, 62.0, 62.0, 66.0, 71.0, 78.0, 81.0, 82.0, 83.0, 91.0, 94.0]",26,15,11,0.5769230769230769,0.4230769230769231
355,2576314,"[14.0, 34.0, 40.0, 41.0, 41.0, 50.0, 52.0, 53.0, 58.0, 65.0, 66.0, 69.0, 69.0, 71.0, 73.0, 78.0, 78.0, 81.0, 82.0, 88.0]",20,9,11,0.45,0.55
356,2576315,"[3.0, 4.0, 7.0, 18.0, 19.0, 22.0, 22.0, 33.0, 34.0, 34.0, 38.0, 39.0, 39.0, 42.0, 47.0, 55.0, 77.0, 82.0, 88.0, 90.0]",20,16,4,0.8,0.2
357,2576316,"[1.0, 2.0, 3.0, 11.0, 16.0, 17.0, 22.0, 22.0, 24.0, 25.0, 28.0, 30.0, 37.0, 44.0, 48.0, 61.0, 62.0, 67.0, 71.0, 72.0, 79.0, 82.0, 84.0, 85.0, 86.0, 87.0, 88.0, 88.0, 90.0, 91.0, 92.0]",31,15,16,0.4838709677419355,0.5161290322580645
358,2576317,"[12.0, 12.0, 14.0, 15.0, 20.0, 29.0, 35.0, 37.0, 38.0, 39.0, 43.0, 46.0, 46.0, 49.0, 53.0, 54.0, 62.0, 65.0, 71.0, 82.0, 83.0, 87.0, 89.0, 91.0, 93.0]",25,16,9,0.64,0.36
359,2576318,"[0.0, 4.0, 7.0, 8.0, 11.0, 12.0, 14.0, 21.0, 22.0, 26.0, 28.0, 29.0, 32.0, 35.0, 40.0, 43.0, 45.0, 46.0, 47.0, 52.0, 52.0, 53.0, 57.0, 60.0, 65.0, 74.0, 75.0, 79.0, 90.0, 94.0]",30,23,7,0.7666666666666667,0.23333333333333334
360,2576319,"[7.0, 11.0, 15.0, 16.0, 17.0, 18.0, 22.0, 35.0, 35.0, 38.0, 39.0, 39.0, 40.0, 46.0, 51.0, 55.0, 59.0, 61.0, 65.0, 67.0, 70.0, 74.0, 75.0, 75.0, 77.0, 77.0, 81.0, 84.0, 85.0, 87.0, 88.0, 93.0, 95.0, 95.0, 96.0]",35,17,18,0.4857142857142857,0.5142857142857142
361,2576320,"[1.0, 11.0, 13.0, 15.0, 17.0, 21.0, 23.0, 25.0, 27.0, 35.0, 36.0, 37.0, 43.0, 45.0, 48.0, 53.0, 54.0, 56.0, 61.0, 63.0, 63.0, 64.0, 65.0, 70.0, 73.0, 80.0, 81.0, 87.0, 88.0]",29,18,11,0.6206896551724138,0.3793103448275862
362,2576321,"[1.0, 9.0, 14.0, 24.0, 39.0, 44.0, 45.0, 47.0, 48.0, 52.0, 54.0, 56.0, 58.0, 63.0, 63.0, 65.0, 69.0, 69.0, 70.0, 73.0, 81.0, 85.0, 90.0, 92.0]",24,13,11,0.5416666666666666,0.4583333333333333
363,2576322,"[6.0, 7.0, 9.0, 11.0, 11.0, 22.0, 32.0, 33.0, 42.0, 48.0, 50.0, 52.0, 58.0, 60.0, 61.0, 61.0, 62.0, 63.0, 67.0, 72.0, 84.0, 87.0]",22,13,9,0.5909090909090909,0.4090909090909091
364,2576323,"[2.0, 5.0, 5.0, 6.0, 12.0, 14.0, 14.0, 19.0, 21.0, 22.0, 34.0, 35.0, 45.0, 46.0, 47.0, 46.0, 52.0, 56.0, 60.0, 62.0, 63.0, 69.0, 71.0, 77.0, 82.0, 85.0, 93.0]",27,18,9,0.6666666666666666,0.3333333333333333
365,2576324,"[2.0, 5.0, 9.0, 12.0, 15.0, 16.0, 23.0, 26.0, 28.0, 32.0, 34.0, 35.0, 36.0, 36.0, 38.0, 40.0, 41.0, 44.0, 56.0, 63.0, 63.0, 66.0, 68.0, 72.0, 72.0, 73.0, 74.0, 80.0, 82.0, 83.0, 86.0, 87.0, 89.0, 90.0, 93.0]",35,19,16,0.5428571428571428,0.45714285714285713
366,2576325,"[7.0, 17.0, 20.0, 28.0, 40.0, 44.0, 46.0, 52.0, 57.0, 61.0, 65.0, 67.0, 72.0, 74.0, 85.0, 85.0, 85.0, 86.0, 88.0, 90.0, 90.0, 96.0]",22,9,13,0.4090909090909091,0.5909090909090909
367,2576326,"[5.0, 6.0, 16.0, 18.0, 19.0, 23.0, 31.0, 39.0, 52.0, 64.0, 74.0, 83.0, 86.0, 94.0, 96.0]",15,9,6,0.6,0.4
368,2576327,"[3.0, 4.0, 7.0, 13.0, 15.0, 19.0, 24.0, 26.0, 27.0, 28.0, 35.0, 38.0, 40.0, 42.0, 45.0, 45.0, 48.0, 52.0, 53.0, 59.0, 63.0, 65.0, 68.0, 69.0, 70.0, 76.0, 77.0, 81.0, 82.0, 86.0, 88.0, 94.0]",32,20,12,0.625,0.375
369,2576328,"[1.0, 2.0, 3.0, 5.0, 9.0, 10.0, 12.0, 21.0, 22.0, 23.0, 26.0, 27.0, 29.0, 31.0, 38.0, 40.0, 47.0, 53.0, 54.0, 55.0, 58.0, 59.0, 62.0, 64.0, 71.0, 73.0, 75.0, 76.0, 79.0, 87.0, 88.0, 89.0, 92.0]",33,22,11,0.6666666666666666,0.3333333333333333
370,2576329,"[1.0, 5.0, 6.0, 17.0, 19.0, 23.0, 25.0, 28.0, 30.0, 34.0, 35.0, 36.0, 38.0, 40.0, 42.0, 45.0, 47.0, 49.0, 51.0, 51.0, 54.0, 56.0, 66.0, 69.0, 72.0, 76.0, 80.0, 82.0, 83.0, 90.0, 90.0, 93.0]",32,22,10,0.6875,0.3125
371,2576330,"[2.0, 7.0, 14.0, 15.0, 17.0, 18.0, 31.0, 33.0, 36.0, 42.0, 44.0, 46.0, 47.0, 54.0, 54.0, 65.0, 69.0, 71.0, 77.0, 83.0, 87.0, 92.0, 93.0, 94.0]",24,15,9,0.625,0.375
372,2576331,"[11.0, 16.0, 18.0, 23.0, 28.0, 51.0, 53.0, 64.0, 65.0, 69.0, 70.0, 71.0, 75.0, 80.0, 81.0, 81.0, 82.0, 84.0, 93.0]",19,7,12,0.3684210526315789,0.631578947368421
373,2576332,"[4.0, 5.0, 25.0, 35.0, 51.0, 52.0, 60.0, 61.0, 69.0, 73.0, 80.0, 88.0]",12,6,6,0.5,0.5
374,2576333,"[5.0, 11.0, 21.0, 24.0, 26.0, 29.0, 31.0, 32.0, 33.0, 47.0, 48.0, 51.0, 73.0, 74.0, 77.0, 86.0]",16,12,4,0.75,0.25
375,2576334,"[2.0, 3.0, 5.0, 5.0, 15.0, 16.0, 20.0, 21.0, 27.0, 29.0, 30.0, 41.0, 43.0, 44.0, 51.0, 55.0, 56.0, 57.0, 67.0, 73.0, 77.0, 78.0, 84.0, 89.0]",24,18,6,0.75,0.25
376,2576335,"[8.0, 12.0, 19.0, 20.0, 22.0, 23.0, 25.0, 33.0, 37.0, 40.0, 47.0, 47.0, 51.0, 54.0, 59.0, 63.0, 68.0, 68.0, 75.0, 77.0, 78.0, 81.0, 85.0, 86.0, 88.0, 92.0, 92.0, 93.0]",28,15,13,0.5357142857142857,0.4642857142857143
377,2576336,"[3.0, 10.0, 14.0, 16.0, 21.0, 23.0, 25.0, 28.0, 30.0, 31.0, 35.0, 37.0, 38.0, 40.0, 46.0, 51.0, 52.0, 72.0, 77.0, 79.0, 84.0, 86.0, 89.0, 90.0]",24,17,7,0.7083333333333334,0.2916666666666667
378,2576337,"[0.0, 2.0, 7.0, 7.0, 11.0, 12.0, 26.0, 28.0, 29.0, 32.0, 32.0, 36.0, 44.0, 46.0, 54.0, 64.0, 67.0, 68.0, 72.0, 74.0, 74.0, 75.0, 75.0]",23,15,8,0.6521739130434783,0.34782608695652173
379,2576338,"[1.0, 2.0, 3.0, 13.0, 20.0, 22.0, 33.0, 35.0, 45.0, 46.0, 49.0, 52.0, 63.0, 68.0, 69.0, 71.0, 78.0, 83.0, 89.0]",19,12,7,0.631578947368421,0.3684210526315789
