,matchId,shots,total shots,early game shots,late game shots,early game shot density,late game shot density
0,2575959,"[3.0, 4.0, 11.0, 23.0, 24.0, 24.0, 25.0, 28.0, 29.0, 35.0, 39.0, 43.0, 48.0, 62.0, 69.0, 70.0, 71.0, 81.0, 86.0, 92.0, 95.0, 95.0]",22,13,9,0.5909090909090909,0.4090909090909091
1,2575960,"[2.0, 4.0, 8.0, 12.0, 16.0, 18.0, 25.0, 27.0, 30.0, 33.0, 43.0, 45.0, 52.0, 57.0, 58.0, 70.0, 79.0, 91.0, 92.0]",19,15,4,0.7894736842105263,0.21052631578947367
2,2575961,"[13.0, 15.0, 17.0, 18.0, 20.0, 22.0, 23.0, 31.0, 33.0, 37.0, 39.0, 48.0, 50.0, 67.0, 68.0, 70.0, 72.0, 78.0, 79.0, 86.0, 87.0, 88.0]",22,13,9,0.5909090909090909,0.4090909090909091
3,2575962,"[3.0, 17.0, 19.0, 22.0, 24.0, 26.0, 28.0, 37.0, 38.0, 41.0, 42.0, 42.0, 43.0, 44.0, 45.0, 50.0, 53.0, 57.0, 59.0, 61.0, 62.0, 62.0, 69.0, 76.0, 77.0, 78.0, 84.0, 85.0, 90.0]",29,19,10,0.6551724137931034,0.3448275862068966
4,2575963,"[9.0, 11.0, 11.0, 14.0, 16.0, 18.0, 23.0, 25.0, 26.0, 26.0, 27.0, 28.0, 33.0, 47.0, 52.0, 58.0, 59.0, 65.0, 69.0, 74.0, 75.0, 75.0, 78.0, 78.0, 79.0, 80.0, 82.0]",27,17,10,0.6296296296296297,0.37037037037037035
5,2575964,"[12.0, 24.0, 34.0, 34.0, 41.0, 44.0, 46.0, 47.0, 47.0, 58.0, 61.0, 64.0, 66.0, 67.0, 83.0, 86.0, 87.0, 89.0, 93.0]",19,10,9,0.5263157894736842,0.47368421052631576
6,2575965,"[7.0, 15.0, 16.0, 17.0, 19.0, 25.0, 26.0, 30.0, 33.0, 35.0, 39.0, 42.0, 43.0, 45.0, 47.0, 50.0, 53.0, 54.0, 61.0, 62.0, 67.0, 74.0, 77.0, 79.0, 80.0, 82.0, 83.0, 83.0, 85.0, 87.0, 95.0]",31,18,13,0.5806451612903226,0.41935483870967744
7,2575966,"[3.0, 4.0, 11.0, 12.0, 14.0, 18.0, 20.0, 24.0, 27.0, 29.0, 31.0, 33.0, 35.0, 36.0, 37.0, 38.0, 38.0, 40.0, 42.0, 45.0, 51.0, 54.0, 58.0, 64.0, 70.0, 73.0, 77.0, 80.0, 92.0, 93.0]",30,23,7,0.7666666666666667,0.23333333333333334
8,2575967,"[1.0, 3.0, 12.0, 12.0, 15.0, 21.0, 22.0, 24.0, 26.0, 29.0, 31.0, 34.0, 37.0, 39.0, 41.0, 51.0, 60.0, 61.0, 71.0, 80.0, 83.0, 87.0, 90.0]",23,16,7,0.6956521739130435,0.30434782608695654
9,2575968,"[1.0, 4.0, 8.0, 11.0, 11.0, 13.0, 14.0, 16.0, 27.0, 30.0, 35.0, 37.0, 42.0, 43.0, 50.0, 53.0, 54.0, 56.0, 61.0, 62.0, 62.0, 69.0, 76.0, 83.0, 89.0, 90.0]",26,18,8,0.6923076923076923,0.3076923076923077
10,2575969,"[11.0, 14.0, 29.0, 31.0, 35.0, 36.0, 42.0, 43.0, 48.0, 54.0, 54.0, 64.0, 67.0, 67.0, 72.0, 72.0, 74.0, 76.0, 78.0, 78.0, 80.0, 89.0, 92.0, 94.0, 97.0]",25,11,14,0.44,0.56
11,2575970,"[11.0, 14.0, 17.0, 18.0, 29.0, 30.0, 34.0, 34.0, 37.0, 37.0, 44.0, 47.0, 49.0, 50.0, 52.0, 52.0, 57.0, 64.0, 68.0, 69.0, 70.0, 73.0, 83.0, 87.0, 88.0, 91.0]",26,17,9,0.6538461538461539,0.34615384615384615
12,2575971,"[4.0, 17.0, 19.0, 23.0, 30.0, 33.0, 40.0, 49.0, 52.0, 56.0, 61.0, 63.0, 70.0, 75.0, 80.0, 83.0]",16,10,6,0.625,0.375
13,2575972,"[9.0, 12.0, 15.0, 21.0, 25.0, 27.0, 30.0, 32.0, 32.0, 37.0, 38.0, 39.0, 41.0, 42.0, 47.0, 49.0, 50.0, 53.0, 54.0, 56.0, 61.0, 62.0, 64.0, 65.0, 65.0, 66.0, 71.0, 74.0, 80.0, 83.0, 83.0, 85.0, 90.0, 92.0, 94.0]",35,20,15,0.5714285714285714,0.42857142857142855
14,2575973,"[10.0, 10.0, 13.0, 20.0, 28.0, 32.0, 37.0, 41.0, 41.0, 43.0, 43.0, 45.0, 48.0, 58.0, 61.0, 66.0, 71.0, 75.0, 83.0, 85.0, 91.0]",21,14,7,0.6666666666666666,0.3333333333333333
15,2575974,"[4.0, 10.0, 14.0, 16.0, 22.0, 24.0, 30.0, 31.0, 31.0, 32.0, 39.0, 40.0, 41.0, 41.0, 44.0, 46.0, 49.0, 51.0, 52.0, 53.0, 56.0, 57.0, 61.0, 65.0, 76.0, 77.0, 82.0, 84.0, 99.0]",29,22,7,0.7586206896551724,0.2413793103448276
16,2575975,"[10.0, 14.0, 15.0, 17.0, 18.0, 25.0, 35.0, 39.0, 39.0, 39.0, 42.0, 42.0, 47.0, 46.0, 51.0, 53.0, 56.0, 59.0, 60.0, 65.0, 80.0, 81.0, 87.0]",23,18,5,0.782608695652174,0.21739130434782608
17,2575976,"[11.0, 11.0, 13.0, 13.0, 15.0, 15.0, 17.0, 20.0, 27.0, 31.0, 39.0, 43.0, 45.0, 47.0, 49.0, 51.0, 54.0, 64.0, 66.0, 66.0, 68.0, 70.0, 72.0, 76.0, 79.0, 82.0, 82.0, 86.0, 88.0, 92.0]",30,17,13,0.5666666666666667,0.43333333333333335
18,2575977,"[9.0, 14.0, 17.0, 19.0, 25.0, 25.0, 26.0, 35.0, 35.0, 38.0, 44.0, 48.0, 53.0, 62.0, 67.0, 71.0, 75.0, 83.0, 92.0, 93.0]",20,13,7,0.65,0.35
19,2575978,"[6.0, 8.0, 15.0, 20.0, 24.0, 30.0, 30.0, 31.0, 35.0, 38.0, 41.0, 43.0, 44.0, 46.0, 51.0, 52.0, 53.0, 56.0, 71.0, 84.0, 88.0, 95.0]",22,18,4,0.8181818181818182,0.18181818181818182
20,2575979,"[10.0, 18.0, 22.0, 23.0, 24.0, 27.0, 34.0, 39.0, 45.0, 50.0, 55.0, 68.0, 70.0, 73.0, 77.0, 87.0, 87.0, 89.0, 93.0]",19,11,8,0.5789473684210527,0.42105263157894735
21,2575980,"[3.0, 5.0, 8.0, 9.0, 11.0, 17.0, 31.0, 33.0, 37.0, 37.0, 38.0, 38.0, 41.0, 41.0, 43.0, 45.0, 52.0, 54.0, 61.0, 68.0, 68.0, 69.0, 71.0, 74.0, 75.0, 77.0, 78.0, 79.0, 83.0, 86.0, 90.0, 92.0]",32,18,14,0.5625,0.4375
22,2575981,"[5.0, 6.0, 18.0, 19.0, 28.0, 32.0, 44.0, 44.0, 48.0, 59.0, 66.0, 68.0, 70.0, 76.0, 83.0, 86.0, 87.0, 92.0, 93.0]",19,10,9,0.5263157894736842,0.47368421052631576
23,2575982,"[8.0, 9.0, 12.0, 18.0, 22.0, 22.0, 24.0, 24.0, 32.0, 33.0, 42.0, 46.0, 52.0, 56.0, 59.0, 68.0, 80.0, 83.0, 85.0, 94.0]",20,15,5,0.75,0.25
24,2575983,"[2.0, 2.0, 13.0, 14.0, 16.0, 23.0, 25.0, 26.0, 28.0, 31.0, 31.0, 35.0, 38.0, 45.0, 48.0, 54.0, 56.0, 57.0, 58.0, 59.0, 67.0, 69.0, 74.0, 76.0, 77.0, 82.0, 84.0, 86.0, 88.0, 89.0, 92.0]",31,20,11,0.6451612903225806,0.3548387096774194
25,2575984,"[4.0, 7.0, 11.0, 14.0, 21.0, 29.0, 35.0, 40.0, 45.0, 46.0, 48.0, 51.0, 62.0, 71.0, 72.0, 73.0, 79.0, 81.0, 84.0, 87.0, 90.0, 91.0, 92.0, 95.0]",24,12,12,0.5,0.5
26,2575985,"[3.0, 9.0, 12.0, 13.0, 20.0, 26.0, 29.0, 29.0, 30.0, 36.0, 38.0, 41.0, 43.0, 51.0, 53.0, 57.0, 58.0, 60.0, 65.0, 70.0, 71.0, 72.0, 77.0, 77.0, 83.0, 91.0]",26,17,9,0.6538461538461539,0.34615384615384615
27,2575986,"[5.0, 8.0, 13.0, 18.0, 36.0, 42.0, 43.0, 43.0, 45.0, 47.0, 49.0, 51.0, 52.0, 54.0, 56.0, 56.0, 62.0, 64.0, 67.0, 70.0, 72.0, 81.0, 84.0, 89.0, 94.0]",25,16,9,0.64,0.36
28,2575987,"[3.0, 4.0, 8.0, 13.0, 14.0, 20.0, 20.0, 22.0, 24.0, 25.0, 26.0, 32.0, 39.0, 41.0, 47.0, 49.0, 52.0, 64.0, 73.0, 76.0, 81.0, 86.0, 88.0, 88.0, 89.0, 91.0]",26,17,9,0.6538461538461539,0.34615384615384615
29,2575988,"[3.0, 7.0, 8.0, 12.0, 15.0, 15.0, 23.0, 26.0, 26.0, 26.0, 29.0, 38.0, 46.0, 47.0, 47.0, 49.0, 63.0, 75.0, 82.0, 82.0, 86.0, 90.0, 90.0]",23,16,7,0.6956521739130435,0.30434782608695654
30,2575989,"[4.0, 10.0, 17.0, 23.0, 25.0, 27.0, 28.0, 36.0, 40.0, 46.0, 48.0, 51.0, 52.0, 57.0, 59.0, 65.0, 69.0, 70.0, 79.0, 81.0, 82.0]",21,15,6,0.7142857142857143,0.2857142857142857
31,2575990,"[8.0, 12.0, 13.0, 25.0, 29.0, 37.0, 44.0, 50.0, 51.0, 55.0, 65.0, 68.0, 69.0, 71.0, 78.0, 82.0, 86.0, 90.0, 92.0]",19,10,9,0.5263157894736842,0.47368421052631576
32,2575991,"[11.0, 13.0, 21.0, 27.0, 29.0, 33.0, 36.0, 40.0, 41.0, 42.0, 50.0, 52.0, 61.0, 65.0, 69.0, 72.0, 73.0, 84.0, 88.0]",19,12,7,0.631578947368421,0.3684210526315789
33,2575992,"[9.0, 13.0, 17.0, 18.0, 21.0, 28.0, 29.0, 40.0, 50.0, 56.0, 60.0, 61.0, 66.0, 69.0, 72.0, 72.0, 77.0, 78.0, 81.0, 82.0, 83.0]",21,10,11,0.47619047619047616,0.5238095238095238
34,2575993,"[7.0, 16.0, 18.0, 18.0, 22.0, 28.0, 30.0, 33.0, 36.0, 47.0, 48.0, 49.0, 52.0, 54.0, 55.0, 62.0, 64.0, 67.0, 71.0, 71.0, 72.0, 76.0, 89.0, 94.0]",24,15,9,0.625,0.375
35,2575994,"[3.0, 3.0, 5.0, 6.0, 7.0, 9.0, 13.0, 14.0, 16.0, 18.0, 24.0, 26.0, 27.0, 32.0, 39.0, 43.0, 46.0, 47.0, 55.0, 60.0, 63.0, 75.0, 75.0, 78.0, 80.0, 82.0, 88.0]",27,19,8,0.7037037037037037,0.2962962962962963
36,2575995,"[1.0, 3.0, 6.0, 9.0, 9.0, 10.0, 16.0, 17.0, 19.0, 21.0, 30.0, 33.0, 35.0, 37.0, 37.0, 42.0, 44.0, 46.0, 47.0, 56.0, 60.0, 61.0, 62.0, 64.0, 67.0, 70.0, 72.0, 72.0, 76.0, 76.0, 78.0, 79.0, 83.0, 85.0, 88.0, 90.0, 92.0]",37,20,17,0.5405405405405406,0.4594594594594595
37,2575996,"[4.0, 7.0, 10.0, 14.0, 15.0, 28.0, 29.0, 31.0, 33.0, 40.0, 48.0, 51.0, 57.0, 60.0, 67.0, 69.0, 78.0, 82.0, 92.0]",19,13,6,0.6842105263157895,0.3157894736842105
38,2575997,"[9.0, 16.0, 16.0, 28.0, 29.0, 29.0, 39.0, 48.0, 52.0, 56.0, 67.0, 67.0, 67.0, 67.0, 71.0, 74.0, 75.0, 80.0, 84.0, 86.0, 89.0]",21,10,11,0.47619047619047616,0.5238095238095238
39,2575998,"[0.0, 5.0, 5.0, 12.0, 14.0, 17.0, 27.0, 29.0, 32.0, 34.0, 36.0, 37.0, 41.0, 45.0, 45.0, 53.0, 56.0, 56.0, 66.0, 76.0, 82.0, 83.0, 86.0, 92.0]",24,18,6,0.75,0.25
40,2575999,"[5.0, 7.0, 14.0, 24.0, 25.0, 28.0, 31.0, 34.0, 38.0, 43.0, 44.0, 45.0, 46.0, 51.0, 61.0, 62.0, 70.0, 72.0, 77.0, 81.0, 92.0]",21,14,7,0.6666666666666666,0.3333333333333333
41,2576000,"[3.0, 5.0, 10.0, 13.0, 14.0, 17.0, 21.0, 26.0, 30.0, 30.0, 31.0, 34.0, 39.0, 42.0, 43.0, 43.0, 44.0, 45.0, 51.0, 54.0, 55.0, 61.0, 61.0, 65.0, 66.0, 68.0, 69.0, 71.0, 76.0, 80.0, 81.0, 82.0, 87.0, 89.0]",34,21,13,0.6176470588235294,0.38235294117647056
42,2576001,"[4.0, 8.0, 8.0, 14.0, 15.0, 17.0, 24.0, 31.0, 35.0, 36.0, 40.0, 47.0, 55.0, 59.0, 60.0, 66.0, 67.0, 84.0]",18,14,4,0.7777777777777778,0.2222222222222222
43,2576002,"[3.0, 5.0, 5.0, 10.0, 20.0, 24.0, 32.0, 37.0, 42.0, 43.0, 44.0, 46.0, 46.0, 53.0, 54.0, 56.0, 57.0, 61.0, 61.0, 61.0, 67.0, 74.0, 74.0, 74.0, 80.0, 90.0, 96.0]",27,17,10,0.6296296296296297,0.37037037037037035
44,2576003,"[1.0, 20.0, 20.0, 29.0, 30.0, 30.0, 33.0, 47.0, 50.0, 55.0, 56.0, 57.0, 61.0, 62.0, 64.0, 68.0, 69.0, 72.0, 78.0, 82.0, 83.0, 91.0, 93.0]",23,12,11,0.5217391304347826,0.4782608695652174
45,2576004,"[13.0, 17.0, 22.0, 23.0, 26.0, 28.0, 32.0, 39.0, 42.0, 42.0, 51.0, 56.0, 67.0, 68.0, 69.0, 70.0, 70.0, 71.0, 72.0, 76.0, 78.0, 78.0, 81.0, 82.0, 84.0, 89.0, 92.0]",27,12,15,0.4444444444444444,0.5555555555555556
46,2576005,"[23.0, 35.0, 35.0, 43.0, 48.0, 52.0, 53.0, 61.0, 61.0, 66.0, 67.0, 70.0, 71.0, 76.0, 85.0, 87.0, 90.0, 90.0, 93.0]",19,7,12,0.3684210526315789,0.631578947368421
47,2576006,"[26.0, 29.0, 37.0, 40.0, 42.0, 43.0, 44.0, 46.0, 49.0, 51.0, 53.0, 54.0, 54.0, 56.0, 59.0, 62.0, 64.0, 83.0, 87.0]",19,15,4,0.7894736842105263,0.21052631578947367
48,2576007,"[10.0, 11.0, 14.0, 16.0, 19.0, 19.0, 24.0, 31.0, 33.0, 34.0, 38.0, 38.0, 46.0, 50.0, 52.0, 57.0, 59.0, 68.0, 76.0, 90.0]",20,17,3,0.85,0.15
49,2576008,"[4.0, 8.0, 8.0, 12.0, 14.0, 27.0, 37.0, 38.0, 42.0, 43.0, 51.0, 62.0, 64.0, 66.0, 66.0, 66.0, 71.0, 71.0, 73.0, 74.0, 74.0, 81.0, 86.0, 89.0, 94.0]",25,11,14,0.44,0.56
50,2576009,"[0.0, 3.0, 5.0, 6.0, 13.0, 15.0, 28.0, 30.0, 32.0, 37.0, 45.0, 53.0, 55.0, 55.0, 57.0, 60.0, 66.0, 79.0, 81.0, 86.0, 87.0, 90.0, 90.0, 92.0]",24,15,9,0.625,0.375
51,2576010,"[5.0, 7.0, 8.0, 8.0, 8.0, 10.0, 11.0, 13.0, 17.0, 18.0, 26.0, 30.0, 40.0, 42.0, 44.0, 49.0, 50.0, 51.0, 52.0, 52.0, 55.0, 57.0, 59.0, 61.0, 64.0, 64.0, 65.0, 69.0, 79.0, 87.0, 90.0, 92.0]",32,23,9,0.71875,0.28125
52,2576011,"[6.0, 10.0, 10.0, 11.0, 16.0, 16.0, 22.0, 22.0, 31.0, 42.0, 46.0, 47.0, 50.0, 52.0, 59.0, 62.0, 63.0, 65.0, 77.0, 79.0, 82.0, 85.0, 85.0, 94.0]",24,15,9,0.625,0.375
53,2576012,"[14.0, 18.0, 19.0, 40.0, 43.0, 46.0, 50.0, 52.0, 52.0, 55.0, 56.0, 59.0, 63.0, 65.0, 78.0, 86.0, 88.0]",17,12,5,0.7058823529411765,0.29411764705882354
54,2576013,"[1.0, 4.0, 12.0, 13.0, 14.0, 18.0, 21.0, 25.0, 29.0, 39.0, 41.0, 42.0, 44.0, 46.0, 50.0, 63.0, 68.0, 70.0, 72.0, 77.0, 86.0, 87.0]",22,15,7,0.6818181818181818,0.3181818181818182
55,2576014,"[6.0, 9.0, 11.0, 11.0, 16.0, 31.0, 32.0, 40.0, 43.0, 44.0, 47.0, 56.0, 61.0, 63.0, 65.0, 65.0, 69.0, 69.0, 70.0, 74.0, 76.0, 84.0, 87.0, 87.0, 88.0, 88.0, 90.0]",27,12,15,0.4444444444444444,0.5555555555555556
56,2576015,"[0.0, 7.0, 12.0, 16.0, 19.0, 20.0, 24.0, 29.0, 30.0, 37.0, 37.0, 38.0, 44.0, 49.0, 53.0, 55.0, 57.0, 60.0, 61.0, 62.0, 64.0, 68.0, 74.0, 75.0, 75.0, 77.0, 81.0, 84.0, 85.0, 89.0, 91.0]",31,17,14,0.5483870967741935,0.45161290322580644
57,2576016,"[16.0, 17.0, 18.0, 33.0, 36.0, 42.0, 42.0, 47.0, 56.0, 63.0, 66.0, 70.0, 71.0, 74.0, 77.0, 78.0, 85.0, 90.0]",18,9,9,0.5,0.5
58,2576017,"[4.0, 18.0, 29.0, 44.0, 45.0, 46.0, 53.0, 58.0, 60.0, 62.0, 72.0, 88.0, 88.0, 93.0, 94.0]",15,8,7,0.5333333333333333,0.4666666666666667
59,2576018,"[5.0, 6.0, 8.0, 11.0, 13.0, 14.0, 15.0, 15.0, 26.0, 39.0, 44.0, 49.0, 59.0, 60.0, 62.0, 64.0, 71.0, 71.0, 72.0, 73.0, 73.0, 78.0, 80.0, 82.0, 88.0, 91.0]",26,13,13,0.5,0.5
60,2576019,"[3.0, 11.0, 13.0, 13.0, 15.0, 21.0, 21.0, 24.0, 30.0, 33.0, 35.0, 36.0, 47.0, 51.0, 55.0, 62.0, 66.0, 71.0, 72.0, 84.0, 84.0]",21,15,6,0.7142857142857143,0.2857142857142857
61,2576020,"[2.0, 6.0, 8.0, 8.0, 9.0, 13.0, 13.0, 14.0, 17.0, 18.0, 24.0, 28.0, 29.0, 29.0, 30.0, 42.0, 43.0, 44.0, 55.0, 57.0, 62.0, 62.0, 65.0, 75.0, 79.0, 83.0, 85.0, 92.0, 95.0]",29,20,9,0.6896551724137931,0.3103448275862069
62,2576021,"[5.0, 8.0, 10.0, 13.0, 14.0, 21.0, 24.0, 25.0, 33.0, 35.0, 40.0, 40.0, 44.0, 46.0, 49.0, 51.0, 51.0, 52.0, 52.0, 54.0, 54.0, 55.0, 57.0, 60.0, 62.0, 66.0, 69.0, 70.0, 74.0, 80.0, 86.0, 92.0]",32,23,9,0.71875,0.28125
63,2576022,"[13.0, 14.0, 18.0, 35.0, 36.0, 37.0, 47.0, 51.0, 53.0, 54.0, 61.0, 64.0, 67.0, 68.0, 71.0, 71.0, 72.0, 74.0, 75.0, 78.0, 80.0, 84.0, 85.0, 86.0, 89.0, 89.0]",26,10,16,0.38461538461538464,0.6153846153846154
64,2576023,"[12.0, 13.0, 15.0, 15.0, 15.0, 30.0, 33.0, 35.0, 39.0, 46.0, 48.0, 52.0, 53.0, 53.0, 55.0, 57.0, 58.0, 62.0, 64.0, 69.0, 69.0, 69.0, 70.0, 71.0, 84.0, 89.0]",26,17,9,0.6538461538461539,0.34615384615384615
65,2576024,"[17.0, 18.0, 19.0, 20.0, 24.0, 32.0, 34.0, 39.0, 41.0, 42.0, 43.0, 46.0, 47.0, 54.0, 58.0, 61.0, 62.0, 68.0, 68.0, 71.0, 72.0, 74.0, 75.0, 76.0, 76.0, 78.0, 83.0, 93.0]",28,15,13,0.5357142857142857,0.4642857142857143
66,2576025,"[0.0, 3.0, 9.0, 21.0, 24.0, 26.0, 33.0, 35.0, 45.0, 47.0, 47.0, 49.0, 50.0, 54.0, 57.0, 59.0, 60.0, 63.0, 72.0, 82.0, 82.0, 85.0, 87.0]",23,16,7,0.6956521739130435,0.30434782608695654
67,2576026,"[2.0, 2.0, 11.0, 14.0, 18.0, 20.0, 21.0, 22.0, 25.0, 26.0, 30.0, 37.0, 38.0, 39.0, 41.0, 44.0, 48.0, 50.0, 51.0, 52.0, 56.0, 58.0, 69.0, 77.0, 81.0, 85.0, 92.0]",27,22,5,0.8148148148148148,0.18518518518518517
68,2576027,"[1.0, 4.0, 8.0, 8.0, 18.0, 19.0, 25.0, 31.0, 44.0, 47.0, 47.0, 49.0, 57.0, 58.0, 59.0, 60.0, 60.0, 61.0, 62.0, 63.0, 64.0, 72.0, 74.0, 78.0, 82.0, 87.0, 87.0, 98.0]",28,15,13,0.5357142857142857,0.4642857142857143
69,2576028,"[2.0, 6.0, 11.0, 12.0, 20.0, 24.0, 35.0, 37.0, 44.0, 44.0, 53.0, 59.0, 60.0, 63.0, 78.0, 81.0, 81.0, 81.0, 83.0, 83.0, 84.0, 91.0]",22,12,10,0.5454545454545454,0.45454545454545453
70,2576029,"[10.0, 18.0, 20.0, 20.0, 30.0, 38.0, 48.0, 61.0, 65.0, 68.0, 76.0, 85.0, 86.0, 88.0, 90.0, 91.0, 92.0, 93.0]",18,7,11,0.3888888888888889,0.6111111111111112
71,2576030,"[8.0, 11.0, 16.0, 22.0, 23.0, 29.0, 31.0, 35.0, 40.0, 41.0, 46.0, 47.0, 48.0, 49.0, 54.0, 54.0, 59.0, 62.0, 67.0, 72.0, 75.0, 84.0, 84.0, 88.0, 88.0, 88.0, 91.0, 93.0, 93.0]",29,17,12,0.5862068965517241,0.41379310344827586
72,2576031,"[1.0, 9.0, 9.0, 10.0, 13.0, 25.0, 26.0, 29.0, 35.0, 39.0, 41.0, 43.0, 45.0, 45.0, 46.0, 48.0, 49.0, 52.0, 53.0, 58.0, 63.0, 84.0, 88.0, 89.0, 92.0, 93.0, 94.0]",27,20,7,0.7407407407407407,0.25925925925925924
73,2576032,"[7.0, 13.0, 24.0, 27.0, 27.0, 30.0, 32.0, 42.0, 48.0, 49.0, 51.0, 57.0, 57.0, 67.0, 69.0, 71.0, 75.0, 75.0, 76.0, 82.0]",20,13,7,0.65,0.35
74,2576033,"[6.0, 7.0, 7.0, 9.0, 14.0, 24.0, 26.0, 32.0, 32.0, 39.0, 47.0, 52.0, 55.0, 61.0, 68.0, 74.0, 79.0, 82.0, 89.0, 92.0, 94.0, 95.0]",22,13,9,0.5909090909090909,0.4090909090909091
75,2576034,"[7.0, 12.0, 19.0, 22.0, 27.0, 32.0, 35.0, 35.0, 41.0, 44.0, 44.0, 48.0, 49.0, 50.0, 50.0, 54.0, 56.0, 60.0, 61.0, 61.0, 62.0, 65.0, 66.0, 71.0, 71.0, 76.0, 80.0, 84.0, 88.0, 91.0]",30,17,13,0.5666666666666667,0.43333333333333335
76,2576035,"[4.0, 10.0, 23.0, 23.0, 27.0, 30.0, 35.0, 36.0, 40.0, 47.0, 48.0, 55.0, 56.0, 57.0, 59.0, 64.0, 67.0, 69.0, 69.0, 80.0, 91.0, 91.0, 92.0]",23,15,8,0.6521739130434783,0.34782608695652173
77,2576036,"[9.0, 11.0, 15.0, 18.0, 19.0, 23.0, 27.0, 34.0, 35.0, 36.0, 46.0, 50.0, 55.0, 56.0, 58.0, 60.0, 63.0, 68.0, 69.0, 69.0, 83.0, 87.0, 89.0, 92.0, 94.0]",25,15,10,0.6,0.4
78,2576037,"[2.0, 9.0, 10.0, 11.0, 12.0, 21.0, 24.0, 25.0, 30.0, 32.0, 33.0, 35.0, 35.0, 39.0, 49.0, 51.0, 55.0, 59.0, 62.0, 64.0, 66.0, 68.0, 70.0, 77.0, 80.0, 81.0, 82.0, 88.0, 89.0, 93.0, 93.0]",31,18,13,0.5806451612903226,0.41935483870967744
79,2576038,"[1.0, 4.0, 4.0, 4.0, 7.0, 17.0, 24.0, 30.0, 35.0, 38.0, 43.0, 44.0, 45.0, 47.0, 50.0, 71.0, 72.0, 74.0, 75.0, 76.0, 77.0, 78.0, 81.0, 90.0, 90.0, 92.0]",26,15,11,0.5769230769230769,0.4230769230769231
80,2576039,"[11.0, 13.0, 34.0, 47.0, 48.0, 49.0, 51.0, 53.0, 61.0, 67.0, 67.0, 70.0, 76.0, 78.0, 81.0, 83.0, 85.0, 85.0, 89.0, 93.0]",20,8,12,0.4,0.6
81,2576040,"[7.0, 7.0, 17.0, 19.0, 32.0, 34.0, 34.0, 35.0, 47.0, 50.0, 51.0, 56.0, 61.0, 71.0, 77.0, 86.0, 87.0, 88.0, 93.0, 94.0]",20,12,8,0.6,0.4
82,2576041,"[6.0, 14.0, 18.0, 21.0, 23.0, 26.0, 26.0, 34.0, 38.0, 43.0, 45.0, 47.0, 49.0, 50.0, 53.0, 56.0, 62.0, 65.0, 66.0, 66.0, 66.0, 71.0, 72.0, 75.0, 78.0, 82.0, 88.0, 89.0, 90.0, 92.0]",30,16,14,0.5333333333333333,0.4666666666666667
83,2576042,"[1.0, 2.0, 10.0, 14.0, 19.0, 24.0, 25.0, 26.0, 36.0, 41.0, 48.0, 53.0, 62.0, 65.0, 67.0, 73.0, 82.0, 84.0, 86.0, 87.0, 91.0]",21,12,9,0.5714285714285714,0.42857142857142855
84,2576043,"[2.0, 5.0, 6.0, 6.0, 13.0, 15.0, 16.0, 17.0, 30.0, 31.0, 43.0, 44.0, 46.0, 51.0, 55.0, 56.0, 59.0, 64.0, 67.0, 69.0, 73.0, 80.0, 83.0, 83.0, 85.0, 89.0]",26,17,9,0.6538461538461539,0.34615384615384615
85,2576044,"[5.0, 9.0, 10.0, 16.0, 19.0, 19.0, 21.0, 21.0, 26.0, 29.0, 34.0, 38.0, 39.0, 41.0, 47.0, 55.0, 57.0, 60.0, 61.0, 64.0, 67.0, 74.0, 77.0, 83.0]",24,17,7,0.7083333333333334,0.2916666666666667
86,2576045,"[3.0, 17.0, 29.0, 38.0, 46.0, 69.0, 70.0, 73.0, 75.0, 84.0, 85.0, 86.0]",12,5,7,0.4166666666666667,0.5833333333333334
87,2576046,"[1.0, 8.0, 8.0, 14.0, 18.0, 24.0, 25.0, 28.0, 29.0, 29.0, 31.0, 33.0, 34.0, 37.0, 37.0, 49.0, 50.0, 54.0, 58.0, 61.0, 67.0, 71.0, 71.0, 73.0, 77.0, 88.0, 94.0]",27,19,8,0.7037037037037037,0.2962962962962963
88,2576047,"[2.0, 22.0, 26.0, 29.0, 34.0, 38.0, 40.0, 40.0, 42.0, 51.0, 52.0, 54.0, 56.0, 71.0, 73.0, 75.0, 89.0, 91.0]",18,13,5,0.7222222222222222,0.2777777777777778
89,2576048,"[7.0, 10.0, 13.0, 17.0, 17.0, 20.0, 21.0, 25.0, 34.0, 34.0, 39.0, 42.0, 45.0, 46.0, 47.0, 52.0, 53.0, 58.0, 73.0, 82.0, 87.0, 90.0]",22,18,4,0.8181818181818182,0.18181818181818182
90,2576049,"[1.0, 3.0, 7.0, 7.0, 8.0, 9.0, 10.0, 11.0, 11.0, 12.0, 14.0, 16.0, 17.0, 18.0, 25.0, 31.0, 36.0, 38.0, 38.0, 45.0, 45.0, 47.0, 48.0, 49.0, 58.0, 59.0, 63.0, 63.0, 66.0, 70.0, 75.0, 85.0, 87.0]",33,26,7,0.7878787878787878,0.21212121212121213
91,2576050,"[3.0, 7.0, 16.0, 24.0, 28.0, 30.0, 33.0, 35.0, 38.0, 39.0, 46.0, 56.0, 66.0, 67.0, 69.0, 79.0, 90.0, 91.0, 93.0]",19,12,7,0.631578947368421,0.3684210526315789
92,2576051,"[9.0, 9.0, 9.0, 31.0, 35.0, 41.0, 42.0, 50.0, 51.0, 55.0, 62.0, 69.0, 75.0, 78.0, 84.0, 89.0, 95.0]",17,10,7,0.5882352941176471,0.4117647058823529
93,2576052,"[9.0, 9.0, 11.0, 11.0, 17.0, 17.0, 18.0, 23.0, 35.0, 38.0, 39.0, 40.0, 49.0, 52.0, 54.0, 54.0, 57.0, 58.0, 61.0, 64.0, 66.0, 73.0, 73.0, 73.0, 78.0, 81.0, 82.0]",27,18,9,0.6666666666666666,0.3333333333333333
94,2576053,"[11.0, 22.0, 24.0, 28.0, 30.0, 35.0, 35.0, 37.0, 47.0, 49.0, 55.0, 58.0, 63.0, 63.0, 65.0, 68.0, 72.0, 76.0, 83.0, 87.0, 89.0]",21,12,9,0.5714285714285714,0.42857142857142855
95,2576054,"[2.0, 3.0, 10.0, 14.0, 21.0, 22.0, 29.0, 32.0, 32.0, 32.0, 37.0, 41.0, 42.0, 47.0, 48.0, 51.0, 52.0, 55.0, 76.0, 77.0, 78.0, 82.0, 86.0, 88.0]",24,18,6,0.75,0.25
96,2576055,"[1.0, 3.0, 4.0, 5.0, 12.0, 15.0, 17.0, 17.0, 23.0, 26.0, 28.0, 30.0, 30.0, 30.0, 31.0, 34.0, 40.0, 44.0, 51.0, 52.0, 52.0, 54.0, 56.0, 58.0, 62.0, 63.0, 66.0, 66.0, 71.0, 71.0, 82.0, 85.0, 86.0, 92.0]",34,24,10,0.7058823529411765,0.29411764705882354
97,2576056,"[5.0, 8.0, 9.0, 9.0, 14.0, 24.0, 32.0, 33.0, 41.0, 52.0, 64.0, 65.0, 70.0, 81.0, 81.0, 87.0, 91.0, 94.0]",18,10,8,0.5555555555555556,0.4444444444444444
98,2576057,"[8.0, 18.0, 19.0, 19.0, 37.0, 39.0, 44.0, 53.0, 53.0, 55.0, 58.0, 65.0, 69.0, 73.0, 77.0, 86.0, 89.0, 91.0, 92.0, 93.0]",20,11,9,0.55,0.45
99,2576058,"[1.0, 7.0, 16.0, 17.0, 18.0, 26.0, 31.0, 40.0, 44.0, 44.0, 48.0, 50.0, 52.0, 54.0, 70.0, 75.0, 80.0, 82.0]",18,14,4,0.7777777777777778,0.2222222222222222
100,2576059,"[1.0, 3.0, 12.0, 23.0, 29.0, 36.0, 37.0, 40.0, 47.0, 47.0, 47.0, 50.0, 52.0, 52.0, 54.0, 54.0, 59.0, 63.0, 68.0, 70.0, 75.0, 77.0, 77.0, 83.0, 84.0, 84.0, 86.0, 87.0]",28,17,11,0.6071428571428571,0.39285714285714285
101,2576060,"[6.0, 7.0, 7.0, 9.0, 13.0, 16.0, 18.0, 19.0, 23.0, 23.0, 27.0, 28.0, 42.0, 44.0, 49.0, 50.0, 56.0, 61.0, 63.0, 65.0, 68.0, 75.0, 77.0, 85.0, 86.0]",25,17,8,0.68,0.32
102,2576061,"[4.0, 5.0, 7.0, 8.0, 10.0, 13.0, 16.0, 22.0, 35.0, 46.0, 48.0, 50.0, 53.0, 54.0, 62.0, 66.0, 66.0, 69.0, 70.0, 70.0, 72.0, 74.0, 80.0, 93.0]",24,14,10,0.5833333333333334,0.4166666666666667
103,2576062,"[6.0, 8.0, 17.0, 17.0, 23.0, 36.0, 38.0, 39.0, 40.0, 45.0, 45.0, 52.0, 55.0, 56.0, 58.0, 63.0, 66.0, 77.0, 77.0, 89.0]",20,15,5,0.75,0.25
104,2576063,"[2.0, 8.0, 14.0, 16.0, 19.0, 19.0, 21.0, 22.0, 27.0, 29.0, 36.0, 39.0, 40.0, 45.0, 47.0, 48.0, 53.0, 54.0, 58.0, 62.0, 66.0, 71.0, 75.0, 83.0, 85.0, 90.0, 93.0]",27,19,8,0.7037037037037037,0.2962962962962963
105,2576064,"[0.0, 5.0, 9.0, 13.0, 19.0, 21.0, 23.0, 26.0, 27.0, 28.0, 29.0, 30.0, 31.0, 31.0, 32.0, 37.0, 41.0, 46.0, 52.0, 61.0, 64.0, 74.0, 77.0, 81.0]",24,19,5,0.7916666666666666,0.20833333333333334
106,2576065,"[0.0, 12.0, 15.0, 17.0, 19.0, 19.0, 19.0, 22.0, 24.0, 27.0, 29.0, 30.0, 38.0, 39.0, 40.0, 42.0, 44.0, 46.0, 47.0, 48.0, 51.0, 54.0, 62.0, 64.0, 82.0, 84.0, 92.0]",27,22,5,0.8148148148148148,0.18518518518518517
107,2576066,"[0.0, 4.0, 4.0, 9.0, 19.0, 21.0, 23.0, 34.0, 35.0, 38.0, 44.0, 49.0, 55.0, 56.0, 64.0, 69.0, 90.0, 91.0]",18,14,4,0.7777777777777778,0.2222222222222222
108,2576067,"[12.0, 13.0, 19.0, 20.0, 21.0, 23.0, 30.0, 32.0, 39.0, 44.0, 49.0, 51.0, 54.0, 56.0, 63.0, 64.0, 65.0, 66.0, 66.0, 73.0, 73.0, 74.0, 78.0, 81.0, 85.0]",25,14,11,0.56,0.44
109,2576068,"[6.0, 26.0, 29.0, 30.0, 32.0, 36.0, 39.0, 41.0, 68.0, 73.0, 87.0]",11,8,3,0.7272727272727273,0.2727272727272727
110,2576069,"[2.0, 10.0, 10.0, 10.0, 19.0, 19.0, 21.0, 23.0, 28.0, 49.0, 56.0, 58.0, 61.0, 63.0, 74.0, 81.0, 89.0, 90.0]",18,12,6,0.6666666666666666,0.3333333333333333
111,2576070,"[7.0, 10.0, 13.0, 19.0, 23.0, 27.0, 28.0, 30.0, 33.0, 36.0, 40.0, 42.0, 42.0, 61.0, 70.0, 70.0, 79.0, 90.0]",18,13,5,0.7222222222222222,0.2777777777777778
112,2576071,"[5.0, 7.0, 16.0, 22.0, 24.0, 24.0, 27.0, 27.0, 37.0, 37.0, 38.0, 45.0, 52.0, 58.0, 61.0, 62.0, 66.0, 67.0, 69.0, 71.0, 72.0, 74.0, 77.0, 84.0, 90.0, 92.0]",26,14,12,0.5384615384615384,0.46153846153846156
113,2576072,"[5.0, 6.0, 15.0, 17.0, 18.0, 18.0, 19.0, 23.0, 32.0, 40.0, 50.0, 58.0, 60.0, 68.0, 70.0, 70.0, 85.0, 90.0, 94.0, 95.0]",20,12,8,0.6,0.4
114,2576073,"[4.0, 8.0, 20.0, 20.0, 24.0, 24.0, 28.0, 30.0, 31.0, 32.0, 33.0, 36.0, 37.0, 38.0, 42.0, 42.0, 42.0, 46.0, 49.0, 56.0, 60.0, 60.0, 62.0, 67.0, 70.0, 70.0, 76.0, 79.0, 84.0, 85.0, 87.0, 88.0, 88.0, 90.0, 91.0, 92.0]",36,20,16,0.5555555555555556,0.4444444444444444
115,2576074,"[1.0, 2.0, 15.0, 18.0, 24.0, 30.0, 38.0, 43.0, 50.0, 52.0, 53.0, 56.0, 58.0, 66.0, 74.0, 75.0, 78.0, 81.0, 83.0, 85.0, 88.0, 90.0, 91.0]",23,13,10,0.5652173913043478,0.43478260869565216
116,2576075,"[6.0, 8.0, 13.0, 18.0, 22.0, 24.0, 37.0, 37.0, 40.0, 42.0, 43.0, 44.0, 48.0, 48.0, 52.0, 52.0, 58.0, 59.0, 62.0, 66.0, 69.0, 73.0, 74.0, 75.0, 76.0, 79.0, 82.0, 84.0, 86.0, 88.0]",30,18,12,0.6,0.4
117,2576076,"[3.0, 6.0, 8.0, 15.0, 27.0, 29.0, 30.0, 31.0, 34.0, 34.0, 40.0, 42.0, 56.0, 59.0, 59.0, 62.0, 65.0, 69.0, 71.0, 77.0, 89.0, 91.0]",22,15,7,0.6818181818181818,0.3181818181818182
118,2576077,"[2.0, 3.0, 26.0, 26.0, 26.0, 40.0, 42.0, 43.0, 45.0, 47.0, 47.0, 56.0, 59.0, 59.0, 63.0, 72.0, 73.0, 77.0, 79.0, 84.0, 87.0, 91.0]",22,14,8,0.6363636363636364,0.36363636363636365
119,2576078,"[3.0, 14.0, 16.0, 19.0, 31.0, 36.0, 37.0, 38.0, 39.0, 47.0, 59.0, 61.0, 61.0, 67.0, 70.0, 72.0, 75.0, 80.0, 81.0, 83.0]",20,11,9,0.55,0.45
120,2576079,"[12.0, 14.0, 17.0, 22.0, 38.0, 41.0, 44.0, 45.0, 52.0, 56.0, 57.0, 64.0, 64.0, 64.0, 64.0, 70.0, 70.0, 72.0, 76.0, 77.0, 81.0, 82.0, 86.0, 93.0]",24,11,13,0.4583333333333333,0.5416666666666666
121,2576080,"[1.0, 2.0, 6.0, 7.0, 9.0, 10.0, 16.0, 20.0, 23.0, 29.0, 32.0, 32.0, 33.0, 40.0, 41.0, 43.0, 52.0, 58.0, 60.0, 61.0, 81.0]",21,18,3,0.8571428571428571,0.14285714285714285
122,2576081,"[2.0, 7.0, 12.0, 18.0, 21.0, 24.0, 26.0, 29.0, 30.0, 32.0, 32.0, 37.0, 40.0, 43.0, 45.0, 46.0, 46.0, 60.0, 63.0, 63.0, 73.0, 76.0, 86.0, 86.0, 90.0, 92.0, 94.0, 94.0]",28,17,11,0.6071428571428571,0.39285714285714285
123,2576082,"[9.0, 16.0, 19.0, 22.0, 24.0, 25.0, 46.0, 51.0, 58.0, 59.0, 76.0, 80.0, 83.0, 91.0, 93.0]",15,10,5,0.6666666666666666,0.3333333333333333
124,2576083,"[2.0, 12.0, 13.0, 14.0, 24.0, 26.0, 27.0, 28.0, 30.0, 31.0, 32.0, 33.0, 40.0, 41.0, 42.0, 44.0, 48.0, 47.0, 50.0, 61.0, 66.0, 71.0, 72.0, 76.0, 79.0, 80.0, 91.0]",27,19,8,0.7037037037037037,0.2962962962962963
125,2576084,"[10.0, 14.0, 16.0, 20.0, 25.0, 26.0, 30.0, 34.0, 35.0, 52.0, 60.0, 60.0, 62.0, 63.0, 67.0, 68.0, 69.0, 75.0, 77.0, 79.0, 85.0, 89.0, 89.0]",23,10,13,0.43478260869565216,0.5652173913043478
126,2576085,"[2.0, 7.0, 11.0, 12.0, 19.0, 29.0, 31.0, 37.0, 45.0, 48.0, 50.0, 51.0, 51.0, 51.0, 56.0, 62.0, 62.0, 71.0, 78.0, 81.0, 82.0, 84.0, 93.0, 93.0, 93.0]",25,15,10,0.6,0.4
127,2576086,"[15.0, 33.0, 34.0, 35.0, 42.0, 42.0, 46.0, 47.0, 50.0, 52.0, 52.0, 55.0, 59.0, 61.0, 62.0, 63.0, 65.0, 73.0, 79.0, 80.0, 82.0, 84.0, 84.0, 85.0]",24,13,11,0.5416666666666666,0.4583333333333333
128,2576087,"[6.0, 9.0, 13.0, 19.0, 23.0, 24.0, 29.0, 31.0, 33.0, 40.0, 50.0, 51.0, 59.0, 65.0, 65.0, 67.0, 72.0, 78.0, 79.0, 80.0, 81.0, 81.0]",22,13,9,0.5909090909090909,0.4090909090909091
129,2576088,"[8.0, 8.0, 11.0, 20.0, 21.0, 25.0, 33.0, 37.0, 38.0, 39.0, 45.0, 48.0, 54.0, 58.0, 59.0, 60.0, 66.0, 67.0, 76.0, 76.0, 88.0, 89.0, 91.0]",23,15,8,0.6521739130434783,0.34782608695652173
130,2576089,"[6.0, 15.0, 17.0, 21.0, 32.0, 35.0, 38.0, 39.0, 43.0, 49.0, 56.0, 61.0, 64.0, 67.0, 70.0, 74.0, 79.0, 93.0]",18,11,7,0.6111111111111112,0.3888888888888889
131,2576090,"[2.0, 2.0, 7.0, 11.0, 15.0, 16.0, 16.0, 16.0, 19.0, 22.0, 34.0, 42.0, 46.0, 45.0, 53.0, 56.0, 66.0, 67.0, 68.0, 72.0, 77.0, 77.0, 80.0, 80.0, 81.0, 83.0, 87.0]",27,16,11,0.5925925925925926,0.4074074074074074
132,2576091,"[3.0, 4.0, 5.0, 12.0, 15.0, 20.0, 22.0, 24.0, 28.0, 36.0, 44.0, 48.0, 49.0, 55.0, 58.0, 61.0, 70.0, 70.0, 80.0, 83.0, 88.0, 94.0]",22,15,7,0.6818181818181818,0.3181818181818182
133,2576092,"[4.0, 4.0, 21.0, 23.0, 31.0, 35.0, 35.0, 35.0, 37.0, 39.0, 44.0, 47.0, 52.0, 55.0, 55.0, 56.0, 57.0, 58.0, 58.0, 59.0, 63.0, 65.0, 68.0, 69.0, 81.0]",25,20,5,0.8,0.2
134,2576093,"[2.0, 13.0, 13.0, 14.0, 16.0, 18.0, 30.0, 33.0, 38.0, 45.0, 48.0, 58.0, 59.0, 65.0, 66.0, 74.0, 76.0, 84.0, 87.0]",19,13,6,0.6842105263157895,0.3157894736842105
135,2576094,"[1.0, 4.0, 9.0, 13.0, 18.0, 19.0, 32.0, 33.0, 33.0, 36.0, 37.0, 37.0, 40.0, 43.0, 51.0, 51.0, 51.0, 59.0, 59.0, 65.0, 71.0, 73.0, 74.0, 75.0, 77.0, 81.0]",26,19,7,0.7307692307692307,0.2692307692307692
136,2576095,"[8.0, 9.0, 13.0, 17.0, 21.0, 21.0, 24.0, 26.0, 29.0, 34.0, 37.0, 38.0, 40.0, 50.0, 52.0, 53.0, 54.0, 57.0, 62.0, 69.0, 71.0, 74.0, 86.0, 86.0, 97.0]",25,18,7,0.72,0.28
137,2576096,"[5.0, 17.0, 18.0, 23.0, 27.0, 42.0, 44.0, 47.0, 48.0, 52.0, 55.0, 67.0, 67.0, 67.0, 68.0, 75.0, 76.0, 79.0, 81.0, 82.0, 85.0, 85.0, 92.0, 92.0]",24,11,13,0.4583333333333333,0.5416666666666666
138,2576097,"[4.0, 6.0, 21.0, 22.0, 22.0, 27.0, 27.0, 31.0, 37.0, 37.0, 40.0, 41.0, 55.0, 55.0, 58.0, 61.0, 65.0, 76.0, 77.0, 81.0, 82.0, 85.0, 88.0, 89.0, 89.0, 91.0, 91.0, 94.0]",28,15,13,0.5357142857142857,0.4642857142857143
139,2576098,"[1.0, 2.0, 12.0, 17.0, 19.0, 25.0, 32.0, 39.0, 50.0, 50.0, 53.0, 63.0, 67.0, 73.0, 76.0, 93.0]",16,11,5,0.6875,0.3125
140,2576099,"[4.0, 10.0, 11.0, 11.0, 14.0, 20.0, 24.0, 27.0, 32.0, 37.0, 37.0, 41.0, 41.0, 50.0, 50.0, 57.0, 68.0, 70.0, 76.0, 79.0, 84.0, 88.0, 91.0, 94.0]",24,16,8,0.6666666666666666,0.3333333333333333
141,2576100,"[4.0, 8.0, 8.0, 11.0, 11.0, 11.0, 25.0, 25.0, 30.0, 41.0, 50.0, 68.0, 70.0, 74.0, 75.0, 80.0, 82.0, 82.0]",18,11,7,0.6111111111111112,0.3888888888888889
142,2576101,"[3.0, 7.0, 8.0, 34.0, 35.0, 40.0, 40.0, 49.0, 51.0, 52.0, 52.0, 58.0, 60.0, 60.0, 65.0, 66.0, 72.0, 81.0, 83.0, 83.0, 86.0, 92.0]",22,12,10,0.5454545454545454,0.45454545454545453
143,2576102,"[2.0, 3.0, 5.0, 5.0, 10.0, 17.0, 24.0, 28.0, 32.0, 34.0, 34.0, 37.0, 37.0, 39.0, 41.0, 45.0, 50.0, 53.0, 57.0, 60.0, 60.0, 61.0, 64.0, 71.0, 74.0, 78.0, 88.0, 93.0]",28,19,9,0.6785714285714286,0.32142857142857145
144,2576103,"[5.0, 7.0, 7.0, 9.0, 10.0, 13.0, 15.0, 18.0, 27.0, 40.0, 46.0, 56.0, 56.0, 57.0, 62.0, 62.0, 64.0, 74.0, 83.0, 92.0]",20,14,6,0.7,0.3
145,2576104,"[1.0, 1.0, 6.0, 9.0, 10.0, 11.0, 12.0, 13.0, 16.0, 17.0, 18.0, 22.0, 23.0, 24.0, 27.0, 34.0, 38.0, 40.0, 41.0, 42.0, 44.0, 47.0, 48.0, 48.0, 49.0, 50.0, 51.0, 53.0, 57.0, 58.0, 58.0, 59.0, 64.0, 68.0, 70.0, 74.0, 77.0, 79.0, 80.0, 83.0, 87.0, 90.0, 90.0, 91.0, 91.0, 91.0, 91.0]",47,32,15,0.6808510638297872,0.3191489361702128
146,2576105,"[1.0, 4.0, 4.0, 12.0, 16.0, 17.0, 21.0, 22.0, 25.0, 29.0, 31.0, 31.0, 31.0, 36.0, 37.0, 38.0, 38.0, 42.0, 45.0, 49.0, 54.0, 54.0, 54.0, 58.0, 68.0, 71.0, 73.0, 93.0]",28,24,4,0.8571428571428571,0.14285714285714285
147,2576106,"[4.0, 7.0, 11.0, 12.0, 13.0, 16.0, 17.0, 17.0, 19.0, 23.0, 25.0, 25.0, 29.0, 29.0, 30.0, 32.0, 32.0, 36.0, 36.0, 36.0, 39.0, 44.0, 44.0, 45.0, 47.0, 48.0, 51.0, 52.0, 55.0, 61.0, 62.0, 68.0, 69.0, 78.0, 83.0, 83.0, 86.0]",37,29,8,0.7837837837837838,0.21621621621621623
148,2576107,"[8.0, 12.0, 14.0, 17.0, 18.0, 19.0, 21.0, 23.0, 27.0, 28.0, 30.0, 35.0, 41.0, 43.0, 45.0, 47.0, 48.0, 51.0, 55.0, 61.0, 65.0, 68.0, 79.0, 79.0, 81.0, 90.0]",26,19,7,0.7307692307692307,0.2692307692307692
149,2576108,"[2.0, 8.0, 12.0, 21.0, 26.0, 28.0, 33.0, 34.0, 39.0, 45.0, 45.0, 47.0, 54.0, 57.0, 58.0, 59.0, 68.0, 69.0, 73.0, 75.0, 75.0, 78.0, 80.0, 80.0, 87.0, 93.0]",26,16,10,0.6153846153846154,0.38461538461538464
150,2576109,"[8.0, 10.0, 11.0, 19.0, 24.0, 26.0, 27.0, 33.0, 45.0, 46.0, 47.0, 48.0, 52.0, 54.0, 56.0, 57.0, 58.0, 59.0, 61.0, 62.0, 64.0, 65.0, 76.0, 85.0, 85.0, 86.0, 90.0, 90.0]",28,18,10,0.6428571428571429,0.35714285714285715
151,2576110,"[2.0, 4.0, 10.0, 12.0, 13.0, 21.0, 23.0, 23.0, 23.0, 23.0, 24.0, 37.0, 41.0, 47.0, 48.0, 50.0, 51.0, 57.0, 60.0, 64.0, 64.0, 68.0, 69.0, 71.0, 73.0, 75.0, 78.0, 82.0, 82.0, 82.0, 83.0, 83.0, 87.0, 87.0, 93.0, 94.0]",36,18,18,0.5,0.5
152,2576111,"[2.0, 4.0, 12.0, 15.0, 16.0, 18.0, 18.0, 21.0, 25.0, 35.0, 44.0, 48.0, 49.0, 49.0, 51.0, 52.0, 57.0, 63.0, 65.0, 66.0, 73.0, 74.0, 75.0, 83.0, 85.0, 87.0, 88.0]",27,17,10,0.6296296296296297,0.37037037037037035
153,2576112,"[8.0, 8.0, 21.0, 32.0, 36.0, 39.0, 42.0, 45.0, 46.0, 52.0, 53.0, 53.0, 56.0, 57.0, 59.0, 60.0, 63.0, 68.0, 70.0, 72.0, 72.0, 78.0, 81.0, 84.0, 84.0, 88.0]",26,15,11,0.5769230769230769,0.4230769230769231
154,2576113,"[4.0, 8.0, 13.0, 18.0, 19.0, 20.0, 21.0, 24.0, 29.0, 31.0, 31.0, 32.0, 36.0, 42.0, 44.0, 46.0, 47.0, 48.0, 49.0, 49.0, 51.0, 51.0, 53.0, 53.0, 61.0, 61.0, 63.0, 65.0, 65.0, 66.0, 68.0, 72.0, 74.0, 80.0, 86.0, 86.0]",36,24,12,0.6666666666666666,0.3333333333333333
155,2576114,"[3.0, 3.0, 10.0, 12.0, 16.0, 17.0, 17.0, 20.0, 22.0, 24.0, 29.0, 34.0, 36.0, 37.0, 38.0, 41.0, 42.0, 54.0, 54.0, 58.0, 61.0, 70.0, 75.0, 77.0, 77.0, 78.0, 79.0, 85.0]",28,20,8,0.7142857142857143,0.2857142857142857
156,2576115,"[6.0, 16.0, 40.0, 41.0, 46.0, 47.0, 49.0, 55.0, 57.0, 64.0, 66.0, 70.0, 71.0, 78.0, 83.0]",15,9,6,0.6,0.4
157,2576116,"[5.0, 7.0, 17.0, 24.0, 26.0, 30.0, 38.0, 39.0, 48.0, 48.0, 52.0, 54.0, 54.0, 61.0, 67.0, 68.0, 73.0, 76.0, 83.0, 84.0, 87.0]",21,13,8,0.6190476190476191,0.38095238095238093
158,2576117,"[6.0, 7.0, 11.0, 14.0, 20.0, 21.0, 26.0, 34.0, 36.0, 38.0, 40.0, 40.0, 42.0, 46.0, 50.0, 60.0, 61.0, 62.0, 63.0, 69.0, 71.0, 72.0, 73.0, 76.0, 84.0, 85.0, 89.0, 90.0, 91.0]",29,15,14,0.5172413793103449,0.4827586206896552
159,2576118,"[3.0, 4.0, 17.0, 21.0, 28.0, 28.0, 28.0, 32.0, 39.0, 41.0, 42.0, 44.0, 51.0, 56.0, 61.0, 61.0, 63.0, 65.0, 66.0, 68.0, 73.0, 75.0, 76.0, 77.0, 81.0, 86.0, 87.0, 90.0]",28,14,14,0.5,0.5
160,2576119,"[12.0, 16.0, 18.0, 20.0, 21.0, 23.0, 23.0, 25.0, 27.0, 35.0, 36.0, 40.0, 55.0, 63.0, 69.0, 72.0, 73.0, 78.0, 89.0, 89.0, 90.0, 91.0]",22,13,9,0.5909090909090909,0.4090909090909091
161,2576120,"[11.0, 21.0, 25.0, 28.0, 29.0, 30.0, 35.0, 39.0, 45.0, 52.0, 53.0, 55.0, 62.0, 64.0, 65.0, 67.0, 68.0, 72.0, 72.0, 73.0, 73.0, 74.0, 81.0, 84.0, 87.0, 87.0, 89.0]",27,12,15,0.4444444444444444,0.5555555555555556
162,2576121,"[18.0, 25.0, 33.0, 36.0, 56.0, 58.0, 63.0, 63.0, 66.0, 67.0, 70.0, 78.0, 88.0, 90.0]",14,6,8,0.42857142857142855,0.5714285714285714
163,2576122,"[4.0, 7.0, 13.0, 16.0, 18.0, 19.0, 24.0, 29.0, 32.0, 33.0, 33.0, 37.0, 40.0, 46.0, 46.0, 46.0, 53.0, 56.0, 65.0, 66.0, 69.0, 79.0, 80.0, 82.0, 83.0, 91.0]",26,18,8,0.6923076923076923,0.3076923076923077
164,2576123,"[4.0, 13.0, 14.0, 15.0, 17.0, 20.0, 24.0, 32.0, 38.0, 40.0, 46.0, 47.0, 49.0, 50.0, 50.0, 52.0, 52.0, 54.0, 63.0, 71.0, 72.0, 81.0, 84.0, 87.0, 87.0]",25,18,7,0.72,0.28
165,2576124,"[1.0, 10.0, 16.0, 18.0, 23.0, 25.0, 25.0, 31.0, 33.0, 35.0, 36.0, 36.0, 37.0, 45.0, 46.0, 46.0, 47.0, 54.0, 58.0, 60.0, 64.0, 68.0, 72.0, 73.0, 74.0, 76.0, 78.0, 83.0, 86.0, 86.0, 88.0, 92.0, 94.0]",33,19,14,0.5757575757575758,0.42424242424242425
166,2576125,"[1.0, 4.0, 6.0, 7.0, 8.0, 12.0, 14.0, 15.0, 19.0, 21.0, 25.0, 29.0, 32.0, 35.0, 35.0, 37.0, 39.0, 40.0, 43.0, 44.0, 45.0, 54.0, 66.0, 67.0, 72.0, 72.0, 76.0, 76.0, 80.0, 81.0, 82.0, 91.0]",32,22,10,0.6875,0.3125
167,2576126,"[2.0, 7.0, 14.0, 15.0, 21.0, 24.0, 25.0, 28.0, 33.0, 33.0, 34.0, 36.0, 39.0, 39.0, 48.0, 61.0, 64.0, 77.0, 83.0, 87.0, 93.0]",21,15,6,0.7142857142857143,0.2857142857142857
168,2576127,"[13.0, 15.0, 19.0, 21.0, 25.0, 29.0, 30.0, 32.0, 39.0, 39.0, 40.0, 40.0, 40.0, 41.0, 43.0, 50.0, 52.0, 55.0, 68.0, 71.0, 80.0, 82.0, 86.0, 89.0]",24,18,6,0.75,0.25
169,2576128,"[3.0, 14.0, 17.0, 25.0, 30.0, 39.0, 43.0, 46.0, 51.0, 56.0, 56.0, 58.0, 62.0, 63.0, 67.0, 77.0, 77.0, 79.0, 85.0]",19,12,7,0.631578947368421,0.3684210526315789
170,2576129,"[9.0, 12.0, 14.0, 19.0, 23.0, 25.0, 25.0, 27.0, 29.0, 31.0, 34.0, 35.0, 37.0, 41.0, 41.0, 42.0, 44.0, 44.0, 47.0, 53.0, 57.0, 61.0, 71.0, 74.0, 76.0, 78.0, 82.0, 85.0]",28,21,7,0.75,0.25
171,2576130,"[0.0, 3.0, 10.0, 18.0, 19.0, 26.0, 27.0, 30.0, 32.0, 33.0, 36.0, 43.0, 46.0, 49.0, 49.0, 53.0, 55.0, 57.0, 78.0, 80.0, 80.0, 81.0, 82.0, 85.0, 90.0, 92.0]",26,18,8,0.6923076923076923,0.3076923076923077
172,2576131,"[19.0, 33.0, 40.0, 42.0, 46.0, 48.0, 48.0, 50.0, 54.0, 63.0, 65.0, 69.0, 71.0, 72.0, 73.0, 73.0, 73.0, 85.0, 86.0, 87.0, 93.0]",21,9,12,0.42857142857142855,0.5714285714285714
173,2576132,"[5.0, 8.0, 9.0, 12.0, 16.0, 18.0, 18.0, 18.0, 24.0, 26.0, 26.0, 32.0, 37.0, 40.0, 43.0, 54.0, 62.0, 65.0, 65.0, 67.0, 68.0, 71.0, 74.0, 77.0, 79.0, 80.0, 86.0, 87.0, 88.0, 89.0, 91.0, 93.0, 95.0]",33,16,17,0.48484848484848486,0.5151515151515151
174,2576133,"[4.0, 6.0, 7.0, 22.0, 23.0, 30.0, 31.0, 39.0, 41.0, 41.0, 44.0, 47.0, 54.0, 55.0, 61.0, 64.0, 71.0, 72.0, 75.0, 78.0, 80.0, 81.0, 82.0, 84.0, 85.0, 86.0, 87.0, 88.0]",28,14,14,0.5,0.5
175,2576134,"[6.0, 15.0, 18.0, 19.0, 23.0, 32.0, 32.0, 36.0, 47.0, 48.0, 50.0, 50.0, 51.0, 52.0, 53.0, 54.0, 61.0, 66.0, 67.0, 71.0, 73.0, 76.0, 86.0, 93.0]",24,16,8,0.6666666666666666,0.3333333333333333
176,2576135,"[8.0, 11.0, 15.0, 15.0, 24.0, 30.0, 33.0, 36.0, 38.0, 41.0, 42.0, 50.0, 74.0, 92.0, 92.0, 92.0]",16,12,4,0.75,0.25
177,2576136,"[1.0, 6.0, 7.0, 16.0, 18.0, 23.0, 25.0, 33.0, 35.0, 39.0, 46.0, 49.0, 50.0, 53.0, 54.0, 65.0, 71.0, 72.0, 73.0, 80.0, 83.0, 84.0, 91.0]",23,15,8,0.6521739130434783,0.34782608695652173
178,2576137,"[0.0, 6.0, 7.0, 9.0, 9.0, 12.0, 18.0, 22.0, 25.0, 27.0, 28.0, 30.0, 40.0, 44.0, 45.0, 46.0, 54.0, 56.0, 56.0, 59.0, 65.0, 67.0, 85.0, 87.0, 87.0, 93.0, 93.0]",27,20,7,0.7407407407407407,0.25925925925925924
179,2576138,"[1.0, 1.0, 15.0, 19.0, 20.0, 27.0, 31.0, 33.0, 40.0, 43.0, 43.0, 44.0, 45.0, 47.0, 52.0, 53.0, 58.0, 67.0, 70.0, 74.0, 75.0, 78.0, 79.0, 85.0, 88.0, 90.0, 91.0]",27,17,10,0.6296296296296297,0.37037037037037035
180,2576139,"[4.0, 6.0, 10.0, 16.0, 23.0, 27.0, 29.0, 30.0, 31.0, 34.0, 41.0, 46.0, 46.0, 47.0, 52.0, 56.0, 66.0, 69.0, 69.0, 70.0, 81.0, 81.0, 88.0, 92.0]",24,16,8,0.6666666666666666,0.3333333333333333
181,2576140,"[5.0, 15.0, 16.0, 17.0, 18.0, 18.0, 19.0, 21.0, 33.0, 34.0, 35.0, 37.0, 38.0, 41.0, 48.0, 48.0, 52.0, 53.0, 54.0, 63.0, 64.0, 67.0, 67.0, 68.0, 83.0, 84.0]",26,19,7,0.7307692307692307,0.2692307692307692
182,2576141,"[1.0, 9.0, 15.0, 17.0, 24.0, 25.0, 27.0, 37.0, 40.0, 47.0, 56.0, 75.0, 82.0, 89.0, 91.0]",15,11,4,0.7333333333333333,0.26666666666666666
183,2576142,"[4.0, 9.0, 13.0, 16.0, 16.0, 29.0, 31.0, 34.0, 38.0, 50.0, 52.0, 54.0, 61.0, 62.0, 63.0, 63.0, 65.0, 71.0, 74.0, 77.0, 87.0, 87.0]",22,12,10,0.5454545454545454,0.45454545454545453
184,2576143,"[7.0, 14.0, 18.0, 41.0, 41.0, 45.0, 46.0, 47.0, 51.0, 54.0, 54.0, 58.0, 60.0, 62.0, 70.0, 73.0, 73.0, 73.0, 75.0, 78.0, 79.0, 85.0, 89.0, 89.0]",24,12,12,0.5,0.5
185,2576144,"[2.0, 5.0, 5.0, 11.0, 14.0, 28.0, 39.0, 57.0, 59.0, 62.0, 67.0, 70.0, 71.0, 77.0, 83.0, 87.0, 92.0]",17,9,8,0.5294117647058824,0.47058823529411764
186,2576145,"[13.0, 16.0, 16.0, 17.0, 19.0, 20.0, 28.0, 30.0, 34.0, 45.0, 46.0, 56.0, 57.0, 68.0, 73.0, 74.0, 79.0, 83.0, 83.0, 88.0, 88.0, 93.0]",22,13,9,0.5909090909090909,0.4090909090909091
187,2576146,"[1.0, 2.0, 7.0, 8.0, 9.0, 10.0, 17.0, 28.0, 31.0, 33.0, 33.0, 36.0, 37.0, 40.0, 40.0, 40.0, 44.0, 47.0, 50.0, 56.0, 57.0, 62.0, 64.0, 65.0, 69.0, 75.0, 76.0, 77.0, 79.0, 80.0, 82.0, 83.0, 92.0, 93.0]",34,21,13,0.6176470588235294,0.38235294117647056
188,2576147,"[13.0, 20.0, 26.0, 30.0, 31.0, 34.0, 35.0, 35.0, 38.0, 38.0, 41.0, 53.0, 54.0, 54.0, 56.0, 61.0, 62.0, 62.0, 63.0, 63.0, 66.0, 73.0, 73.0, 75.0, 81.0, 83.0, 93.0, 94.0]",28,15,13,0.5357142857142857,0.4642857142857143
189,2576148,"[0.0, 15.0, 16.0, 17.0, 18.0, 19.0, 22.0, 28.0, 33.0, 34.0, 39.0, 40.0, 41.0, 46.0, 53.0, 57.0, 70.0, 77.0, 81.0]",19,16,3,0.8421052631578947,0.15789473684210525
190,2576149,"[5.0, 11.0, 13.0, 13.0, 16.0, 19.0, 21.0, 32.0, 33.0, 36.0, 41.0, 48.0, 49.0, 54.0, 54.0, 55.0, 57.0, 60.0, 70.0, 77.0, 79.0, 80.0, 84.0, 84.0, 85.0, 86.0, 87.0]",27,17,10,0.6296296296296297,0.37037037037037035
191,2576150,"[1.0, 2.0, 7.0, 17.0, 19.0, 24.0, 27.0, 35.0, 38.0, 52.0, 55.0, 60.0, 61.0, 62.0, 64.0, 76.0, 84.0, 85.0, 93.0]",19,11,8,0.5789473684210527,0.42105263157894735
192,2576151,"[1.0, 2.0, 5.0, 9.0, 10.0, 11.0, 15.0, 21.0, 21.0, 25.0, 27.0, 35.0, 38.0, 39.0, 41.0, 41.0, 49.0, 53.0, 57.0, 58.0, 63.0, 63.0, 69.0, 73.0, 73.0, 76.0, 77.0, 80.0, 89.0, 94.0, 95.0, 97.0]",32,20,12,0.625,0.375
193,2576152,"[4.0, 8.0, 11.0, 15.0, 16.0, 17.0, 17.0, 21.0, 26.0, 31.0, 41.0, 46.0, 48.0, 49.0, 55.0, 57.0, 58.0, 60.0, 65.0, 75.0, 77.0, 82.0, 85.0, 91.0, 93.0, 94.0]",26,17,9,0.6538461538461539,0.34615384615384615
194,2576153,"[6.0, 8.0, 14.0, 16.0, 25.0, 30.0, 31.0, 34.0, 35.0, 38.0, 43.0, 45.0, 53.0, 55.0, 55.0, 62.0, 63.0, 66.0, 69.0, 70.0, 72.0, 74.0, 77.0, 78.0, 78.0, 81.0, 82.0, 83.0, 86.0, 90.0, 90.0, 94.0, 94.0]",33,15,18,0.45454545454545453,0.5454545454545454
195,2576154,"[9.0, 9.0, 10.0, 14.0, 17.0, 18.0, 26.0, 26.0, 28.0, 43.0, 45.0, 54.0, 59.0, 63.0, 69.0, 72.0, 74.0, 76.0, 87.0, 90.0, 91.0]",21,13,8,0.6190476190476191,0.38095238095238093
196,2576155,"[1.0, 4.0, 9.0, 15.0, 18.0, 22.0, 25.0, 30.0, 32.0, 35.0, 36.0, 37.0, 40.0, 45.0, 50.0, 64.0, 67.0, 72.0, 73.0, 74.0, 74.0, 82.0, 85.0, 86.0, 89.0]",25,15,10,0.6,0.4
197,2576156,"[9.0, 9.0, 10.0, 10.0, 15.0, 17.0, 23.0, 27.0, 30.0, 35.0, 39.0, 45.0, 45.0, 49.0, 52.0, 55.0, 62.0, 62.0, 63.0, 64.0, 66.0, 69.0, 71.0, 78.0, 82.0, 90.0, 91.0, 94.0]",28,16,12,0.5714285714285714,0.42857142857142855
198,2576157,"[9.0, 12.0, 17.0, 22.0, 23.0, 27.0, 47.0, 47.0, 45.0, 48.0, 49.0, 66.0, 68.0, 72.0, 74.0, 79.0, 82.0, 90.0, 90.0]",19,11,8,0.5789473684210527,0.42105263157894735
199,2576158,"[3.0, 6.0, 9.0, 31.0, 34.0, 34.0, 45.0, 51.0, 55.0, 55.0, 57.0, 59.0, 63.0, 66.0, 74.0, 84.0, 85.0, 90.0]",18,12,6,0.6666666666666666,0.3333333333333333
200,2576159,"[1.0, 7.0, 11.0, 34.0, 43.0, 62.0, 73.0, 82.0, 85.0, 88.0]",10,5,5,0.5,0.5
201,2576160,"[6.0, 9.0, 13.0, 15.0, 19.0, 20.0, 23.0, 23.0, 24.0, 29.0, 31.0, 41.0, 42.0, 45.0, 47.0, 52.0, 58.0, 62.0, 63.0, 68.0, 74.0, 75.0, 77.0, 79.0, 83.0, 83.0, 86.0]",27,17,10,0.6296296296296297,0.37037037037037035
202,2576161,"[0.0, 4.0, 5.0, 11.0, 20.0, 22.0, 47.0, 53.0, 58.0, 64.0, 67.0, 73.0, 80.0, 91.0]",14,9,5,0.6428571428571429,0.35714285714285715
203,2576162,"[1.0, 13.0, 16.0, 16.0, 17.0, 20.0, 26.0, 29.0, 31.0, 42.0, 46.0, 50.0, 54.0, 55.0, 60.0, 63.0, 64.0, 64.0, 68.0, 76.0, 77.0, 80.0, 87.0, 88.0, 89.0, 93.0]",26,14,12,0.5384615384615384,0.46153846153846156
204,2576163,"[2.0, 4.0, 16.0, 22.0, 25.0, 29.0, 32.0, 40.0, 44.0, 47.0, 49.0, 57.0, 61.0, 63.0, 69.0, 81.0, 84.0, 88.0, 89.0, 92.0]",20,12,8,0.6,0.4
205,2576164,"[8.0, 14.0, 14.0, 17.0, 24.0, 24.0, 26.0, 29.0, 29.0, 31.0, 41.0, 42.0, 42.0, 48.0, 46.0, 47.0, 53.0, 58.0, 61.0, 70.0, 71.0, 75.0, 85.0, 95.0]",24,18,6,0.75,0.25
206,2576165,"[10.0, 13.0, 15.0, 21.0, 23.0, 23.0, 48.0, 53.0, 60.0, 64.0, 68.0, 71.0, 71.0, 82.0, 83.0, 84.0, 85.0, 89.0, 90.0]",19,8,11,0.42105263157894735,0.5789473684210527
207,2576166,"[7.0, 9.0, 15.0, 17.0, 20.0, 28.0, 29.0, 30.0, 31.0, 33.0, 34.0, 53.0, 61.0, 67.0, 71.0, 73.0, 77.0, 79.0, 83.0, 86.0, 90.0]",21,12,9,0.5714285714285714,0.42857142857142855
208,2576167,"[5.0, 10.0, 15.0, 31.0, 32.0, 35.0, 36.0, 46.0, 48.0, 54.0, 64.0, 71.0, 73.0, 73.0, 73.0, 79.0, 83.0, 83.0]",18,10,8,0.5555555555555556,0.4444444444444444
209,2576168,"[2.0, 11.0, 17.0, 18.0, 21.0, 26.0, 30.0, 31.0, 35.0, 37.0, 40.0, 41.0, 48.0, 53.0, 53.0, 55.0, 59.0, 67.0, 70.0, 71.0, 72.0, 75.0, 77.0, 85.0]",24,17,7,0.7083333333333334,0.2916666666666667
210,2576169,"[5.0, 6.0, 12.0, 18.0, 21.0, 21.0, 22.0, 25.0, 29.0, 33.0, 35.0, 46.0, 46.0, 47.0, 47.0, 56.0, 59.0, 64.0, 74.0, 78.0, 83.0, 85.0, 85.0, 93.0, 95.0]",25,17,8,0.68,0.32
211,2576170,"[3.0, 11.0, 12.0, 13.0, 13.0, 20.0, 32.0, 36.0, 39.0, 42.0, 44.0, 44.0, 45.0, 54.0, 62.0, 74.0, 82.0, 83.0, 85.0]",19,14,5,0.7368421052631579,0.2631578947368421
212,2576171,"[0.0, 6.0, 9.0, 16.0, 17.0, 22.0, 22.0, 26.0, 27.0, 56.0, 58.0, 60.0, 63.0, 72.0, 73.0, 89.0]",16,11,5,0.6875,0.3125
213,2576172,"[12.0, 19.0, 19.0, 20.0, 38.0, 39.0, 44.0, 50.0, 46.0, 53.0, 53.0, 53.0, 55.0, 63.0, 68.0, 77.0, 82.0, 86.0]",18,13,5,0.7222222222222222,0.2777777777777778
214,2576173,"[1.0, 1.0, 2.0, 3.0, 10.0, 13.0, 18.0, 19.0, 20.0, 32.0, 33.0, 38.0, 43.0, 46.0, 46.0, 52.0, 53.0, 55.0, 59.0, 63.0, 66.0, 69.0, 69.0, 70.0, 72.0, 73.0, 74.0, 75.0, 77.0, 77.0, 77.0, 83.0, 87.0, 92.0]",34,19,15,0.5588235294117647,0.4411764705882353
215,2576174,"[0.0, 13.0, 20.0, 31.0, 37.0, 45.0, 53.0, 54.0, 58.0, 60.0, 64.0, 67.0, 70.0, 71.0, 74.0, 74.0, 75.0, 79.0, 83.0, 90.0, 94.0]",21,9,12,0.42857142857142855,0.5714285714285714
216,2576175,"[6.0, 10.0, 20.0, 30.0, 44.0, 45.0, 54.0, 54.0, 56.0, 59.0, 66.0, 71.0, 75.0, 81.0, 82.0, 87.0]",16,10,6,0.625,0.375
217,2576176,"[3.0, 10.0, 15.0, 20.0, 29.0, 31.0, 40.0, 42.0, 43.0, 50.0, 53.0, 60.0, 61.0, 65.0, 67.0, 68.0, 69.0, 71.0, 76.0, 88.0, 94.0]",21,11,10,0.5238095238095238,0.47619047619047616
218,2576177,"[8.0, 11.0, 17.0, 24.0, 26.0, 27.0, 28.0, 29.0, 30.0, 37.0, 38.0, 41.0, 42.0, 44.0, 48.0, 49.0, 49.0, 49.0, 53.0, 55.0, 56.0, 60.0, 64.0, 67.0, 69.0, 71.0, 79.0, 80.0, 83.0, 92.0]",30,21,9,0.7,0.3
219,2576178,"[2.0, 3.0, 3.0, 12.0, 25.0, 26.0, 34.0, 34.0, 36.0, 42.0, 43.0, 43.0, 46.0, 61.0, 61.0, 66.0, 70.0, 78.0, 78.0, 79.0, 80.0, 83.0, 84.0, 84.0, 85.0, 89.0, 92.0]",27,13,14,0.48148148148148145,0.5185185185185185
220,2576179,"[10.0, 13.0, 16.0, 23.0, 26.0, 31.0, 34.0, 40.0, 42.0, 45.0, 46.0, 49.0, 54.0, 60.0, 62.0, 66.0, 66.0, 71.0, 72.0, 75.0, 79.0, 79.0, 84.0, 85.0]",24,13,11,0.5416666666666666,0.4583333333333333
221,2576180,"[11.0, 13.0, 15.0, 21.0, 22.0, 22.0, 23.0, 34.0, 40.0, 42.0, 52.0, 60.0, 62.0, 68.0, 70.0, 73.0, 74.0, 76.0, 80.0, 88.0, 91.0, 91.0, 94.0]",23,11,12,0.4782608695652174,0.5217391304347826
222,2576181,"[14.0, 16.0, 19.0, 21.0, 23.0, 24.0, 24.0, 31.0, 36.0, 40.0, 43.0, 51.0, 66.0, 70.0, 71.0, 75.0, 92.0]",17,12,5,0.7058823529411765,0.29411764705882354
223,2576182,"[4.0, 7.0, 9.0, 10.0, 13.0, 20.0, 25.0, 30.0, 37.0, 39.0, 39.0, 40.0, 41.0, 46.0, 46.0, 48.0, 52.0, 53.0, 54.0, 58.0, 62.0, 74.0, 78.0, 85.0, 91.0]",25,20,5,0.8,0.2
224,2576183,"[0.0, 9.0, 12.0, 18.0, 23.0, 27.0, 36.0, 37.0, 42.0, 54.0, 55.0, 63.0, 65.0, 66.0, 69.0, 74.0, 75.0, 78.0, 79.0, 84.0, 85.0, 88.0, 90.0, 92.0]",24,11,13,0.4583333333333333,0.5416666666666666
225,2576184,"[4.0, 6.0, 8.0, 11.0, 13.0, 15.0, 17.0, 19.0, 25.0, 25.0, 26.0, 28.0, 38.0, 40.0, 40.0, 41.0, 46.0, 52.0, 52.0, 64.0, 64.0, 65.0, 72.0, 79.0, 82.0, 85.0, 91.0, 93.0, 95.0, 95.0]",30,19,11,0.6333333333333333,0.36666666666666664
226,2576185,"[1.0, 3.0, 5.0, 7.0, 15.0, 16.0, 19.0, 22.0, 23.0, 32.0, 37.0, 39.0, 46.0, 46.0, 54.0, 57.0, 62.0, 67.0, 72.0, 75.0, 75.0, 80.0, 92.0, 93.0]",24,16,8,0.6666666666666666,0.3333333333333333
227,2576186,"[8.0, 8.0, 10.0, 23.0, 24.0, 27.0, 32.0, 35.0, 36.0, 37.0, 39.0, 46.0, 47.0, 59.0, 62.0, 68.0, 74.0, 76.0, 82.0, 86.0, 89.0]",21,14,7,0.6666666666666666,0.3333333333333333
228,2576187,"[8.0, 19.0, 24.0, 28.0, 28.0, 33.0, 35.0, 47.0, 49.0, 53.0, 56.0, 75.0, 77.0, 80.0, 84.0, 87.0, 92.0, 93.0, 93.0, 93.0]",20,11,9,0.55,0.45
229,2576188,"[6.0, 8.0, 9.0, 17.0, 20.0, 24.0, 27.0, 28.0, 39.0, 47.0, 50.0, 55.0, 58.0, 59.0, 61.0, 66.0, 67.0, 72.0, 82.0, 84.0, 91.0, 92.0]",22,14,8,0.6363636363636364,0.36363636363636365
230,2576189,"[10.0, 11.0, 12.0, 15.0, 16.0, 17.0, 18.0, 19.0, 24.0, 28.0, 30.0, 54.0, 77.0, 79.0, 83.0, 87.0, 87.0, 87.0, 91.0]",19,12,7,0.631578947368421,0.3684210526315789
231,2576190,"[6.0, 8.0, 9.0, 12.0, 15.0, 17.0, 20.0, 20.0, 26.0, 31.0, 40.0, 41.0, 47.0, 59.0, 62.0, 68.0, 71.0, 75.0, 76.0, 89.0, 90.0, 93.0]",22,14,8,0.6363636363636364,0.36363636363636365
232,2576191,"[2.0, 10.0, 14.0, 23.0, 23.0, 24.0, 33.0, 33.0, 38.0, 44.0, 44.0, 48.0, 48.0, 53.0, 53.0, 54.0, 62.0, 65.0, 66.0, 66.0, 86.0]",21,16,5,0.7619047619047619,0.23809523809523808
233,2576192,"[2.0, 6.0, 11.0, 15.0, 28.0, 30.0, 37.0, 40.0, 44.0, 46.0, 55.0, 56.0, 59.0, 65.0, 69.0, 70.0, 72.0, 79.0, 81.0, 91.0]",20,13,7,0.65,0.35
234,2576193,"[4.0, 4.0, 5.0, 23.0, 29.0, 50.0, 54.0, 71.0, 82.0, 86.0, 90.0]",11,7,4,0.6363636363636364,0.36363636363636365
235,2576194,"[2.0, 7.0, 10.0, 11.0, 16.0, 19.0, 31.0, 34.0, 36.0, 44.0, 49.0, 54.0, 55.0, 67.0, 70.0, 73.0, 75.0, 83.0, 91.0, 92.0, 94.0]",21,13,8,0.6190476190476191,0.38095238095238093
236,2576195,"[5.0, 17.0, 38.0, 43.0, 46.0, 53.0, 60.0, 61.0, 67.0, 70.0, 75.0, 76.0, 85.0, 92.0, 93.0]",15,6,9,0.4,0.6
237,2576196,"[3.0, 16.0, 20.0, 22.0, 29.0, 34.0, 35.0, 38.0, 43.0, 46.0, 46.0, 47.0, 49.0, 52.0, 56.0, 58.0, 69.0, 72.0, 74.0, 76.0, 82.0, 84.0]",22,16,6,0.7272727272727273,0.2727272727272727
238,2576197,"[2.0, 2.0, 7.0, 8.0, 11.0, 21.0, 26.0, 33.0, 34.0, 43.0, 45.0, 49.0, 51.0, 60.0, 61.0, 61.0, 62.0, 64.0, 65.0, 65.0, 72.0, 72.0, 75.0, 90.0]",24,13,11,0.5416666666666666,0.4583333333333333
239,2576198,"[1.0, 1.0, 9.0, 23.0, 31.0, 32.0, 40.0, 45.0, 45.0, 46.0, 46.0, 65.0, 69.0, 70.0, 71.0, 81.0, 83.0, 83.0, 88.0, 89.0, 91.0, 93.0, 95.0]",23,11,12,0.4782608695652174,0.5217391304347826
240,2576199,"[1.0, 10.0, 15.0, 24.0, 28.0, 35.0, 38.0, 63.0, 67.0, 76.0, 81.0, 87.0]",12,7,5,0.5833333333333334,0.4166666666666667
241,2576200,"[2.0, 4.0, 6.0, 11.0, 15.0, 16.0, 16.0, 21.0, 33.0, 36.0, 36.0, 44.0, 46.0, 47.0, 54.0, 55.0, 56.0, 59.0, 64.0, 70.0, 72.0, 79.0, 81.0, 81.0, 82.0, 84.0, 86.0, 86.0, 87.0, 88.0, 93.0]",31,18,13,0.5806451612903226,0.41935483870967744
242,2576201,"[5.0, 8.0, 16.0, 16.0, 20.0, 27.0, 31.0, 40.0, 41.0, 41.0, 45.0, 58.0, 61.0, 65.0, 65.0, 75.0, 76.0, 79.0, 85.0, 90.0, 91.0, 92.0]",22,12,10,0.5454545454545454,0.45454545454545453
243,2576202,"[2.0, 4.0, 5.0, 7.0, 8.0, 9.0, 10.0, 11.0, 11.0, 13.0, 14.0, 16.0, 17.0, 20.0, 22.0, 22.0, 28.0, 29.0, 33.0, 33.0, 43.0, 45.0, 45.0, 46.0, 50.0, 55.0, 57.0, 59.0, 59.0, 62.0, 66.0, 77.0, 79.0, 85.0, 86.0, 87.0, 93.0, 93.0]",38,29,9,0.7631578947368421,0.23684210526315788
244,2576203,"[8.0, 18.0, 25.0, 31.0, 35.0, 43.0, 58.0, 59.0, 63.0, 65.0, 68.0, 71.0, 71.0, 76.0, 78.0, 79.0, 79.0, 79.0, 82.0, 87.0, 87.0, 91.0]",22,8,14,0.36363636363636365,0.6363636363636364
245,2576204,"[20.0, 21.0, 26.0, 28.0, 33.0, 63.0, 66.0, 68.0, 69.0, 70.0, 73.0, 75.0, 78.0]",13,5,8,0.38461538461538464,0.6153846153846154
246,2576205,"[5.0, 6.0, 10.0, 24.0, 27.0, 28.0, 29.0, 30.0, 31.0, 33.0, 34.0, 39.0, 51.0, 55.0, 55.0, 56.0, 60.0, 65.0, 70.0, 71.0, 73.0, 75.0, 80.0, 90.0, 90.0]",25,16,9,0.64,0.36
247,2576206,"[3.0, 12.0, 13.0, 17.0, 19.0, 19.0, 20.0, 23.0, 27.0, 29.0, 34.0, 36.0, 39.0, 39.0, 46.0, 52.0, 58.0, 69.0, 73.0, 75.0, 80.0, 88.0, 89.0, 91.0, 91.0]",25,17,8,0.68,0.32
248,2576207,"[0.0, 2.0, 6.0, 11.0, 17.0, 19.0, 26.0, 27.0, 34.0, 35.0, 38.0, 49.0, 49.0, 53.0, 56.0, 57.0, 57.0, 61.0, 68.0, 69.0, 78.0, 80.0, 89.0, 93.0, 93.0]",25,17,8,0.68,0.32
249,2576208,"[3.0, 6.0, 8.0, 9.0, 12.0, 18.0, 25.0, 26.0, 29.0, 30.0, 39.0, 43.0, 44.0, 48.0, 54.0, 55.0, 59.0, 69.0, 72.0, 74.0, 79.0, 80.0, 92.0, 95.0]",24,17,7,0.7083333333333334,0.2916666666666667
250,2576209,"[3.0, 7.0, 9.0, 18.0, 19.0, 19.0, 28.0, 32.0, 33.0, 35.0, 42.0, 48.0, 49.0, 53.0, 64.0, 67.0, 67.0, 80.0]",18,14,4,0.7777777777777778,0.2222222222222222
251,2576210,"[16.0, 22.0, 22.0, 25.0, 27.0, 34.0, 48.0, 54.0, 57.0, 62.0, 66.0, 68.0, 70.0, 84.0, 87.0, 87.0, 92.0]",17,9,8,0.5294117647058824,0.47058823529411764
252,2576211,"[3.0, 5.0, 9.0, 39.0, 40.0, 43.0, 43.0, 47.0, 60.0, 62.0, 65.0, 68.0, 71.0, 72.0, 79.0, 88.0, 94.0]",17,8,9,0.47058823529411764,0.5294117647058824
253,2576212,"[19.0, 22.0, 24.0, 32.0, 41.0, 44.0, 48.0, 49.0, 55.0, 58.0, 59.0, 62.0, 62.0, 69.0, 72.0, 73.0, 75.0, 76.0, 83.0, 88.0, 89.0, 92.0, 93.0]",23,11,12,0.4782608695652174,0.5217391304347826
254,2576213,"[5.0, 7.0, 23.0, 36.0, 38.0, 47.0, 47.0, 46.0, 49.0, 52.0, 57.0, 57.0, 67.0, 69.0, 74.0, 74.0, 92.0]",17,12,5,0.7058823529411765,0.29411764705882354
255,2576214,"[5.0, 5.0, 7.0, 9.0, 11.0, 28.0, 38.0, 41.0, 45.0, 46.0, 47.0, 51.0, 51.0, 53.0, 53.0, 54.0, 57.0, 62.0, 72.0, 73.0, 78.0, 82.0, 86.0, 86.0, 91.0]",25,17,8,0.68,0.32
256,2576215,"[2.0, 5.0, 6.0, 6.0, 9.0, 10.0, 13.0, 14.0, 15.0, 18.0, 20.0, 24.0, 27.0, 28.0, 38.0, 41.0, 47.0, 61.0, 71.0, 76.0, 80.0, 83.0]",22,17,5,0.7727272727272727,0.22727272727272727
257,2576216,"[2.0, 5.0, 5.0, 8.0, 22.0, 24.0, 25.0, 27.0, 29.0, 31.0, 37.0, 49.0, 49.0, 51.0, 53.0, 55.0, 58.0, 59.0, 63.0, 66.0, 72.0, 72.0, 73.0, 73.0, 78.0, 86.0, 93.0]",27,18,9,0.6666666666666666,0.3333333333333333
258,2576217,"[11.0, 14.0, 20.0, 20.0, 22.0, 28.0, 47.0, 48.0, 52.0, 56.0, 63.0, 64.0, 70.0, 75.0, 77.0, 77.0, 86.0, 86.0, 90.0]",19,10,9,0.5263157894736842,0.47368421052631576
259,2576218,"[4.0, 7.0, 9.0, 13.0, 15.0, 20.0, 23.0, 25.0, 29.0, 30.0, 32.0, 34.0, 38.0, 42.0, 52.0, 55.0, 59.0, 59.0, 60.0, 65.0, 65.0, 68.0, 70.0, 77.0, 83.0, 96.0, 96.0]",27,18,9,0.6666666666666666,0.3333333333333333
260,2576219,"[2.0, 15.0, 23.0, 26.0, 27.0, 32.0, 33.0, 36.0, 45.0, 47.0, 49.0, 52.0, 71.0, 86.0, 93.0]",15,12,3,0.8,0.2
261,2576220,"[13.0, 24.0, 25.0, 43.0, 49.0, 50.0, 53.0, 78.0, 80.0, 89.0, 90.0]",11,7,4,0.6363636363636364,0.36363636363636365
262,2576221,"[2.0, 16.0, 16.0, 18.0, 19.0, 27.0, 36.0, 38.0, 42.0, 45.0, 46.0, 50.0, 54.0, 62.0, 65.0, 67.0, 74.0, 83.0, 90.0]",19,13,6,0.6842105263157895,0.3157894736842105
263,2576222,"[6.0, 10.0, 17.0, 18.0, 19.0, 26.0, 31.0, 31.0, 36.0, 37.0, 46.0, 47.0, 48.0, 61.0, 70.0, 71.0, 76.0, 80.0, 81.0, 82.0, 83.0, 86.0, 86.0, 93.0]",24,13,11,0.5416666666666666,0.4583333333333333
264,2576223,"[4.0, 6.0, 8.0, 10.0, 12.0, 25.0, 32.0, 33.0, 41.0, 42.0, 48.0, 50.0, 56.0, 56.0, 63.0, 63.0, 63.0, 65.0, 65.0, 69.0, 84.0, 88.0, 91.0]",23,14,9,0.6086956521739131,0.391304347826087
265,2576224,"[2.0, 9.0, 18.0, 19.0, 21.0, 25.0, 27.0, 28.0, 37.0, 45.0, 47.0, 48.0, 49.0, 51.0, 52.0, 53.0, 56.0, 59.0, 64.0, 64.0, 64.0, 67.0, 75.0, 81.0, 88.0, 91.0, 92.0]",27,18,9,0.6666666666666666,0.3333333333333333
266,2576225,"[4.0, 9.0, 18.0, 19.0, 22.0, 37.0, 65.0, 65.0, 92.0, 93.0]",10,6,4,0.6,0.4
267,2576226,"[1.0, 2.0, 5.0, 7.0, 9.0, 11.0, 16.0, 16.0, 19.0, 24.0, 26.0, 31.0, 37.0, 39.0, 41.0, 42.0, 43.0, 45.0, 50.0, 50.0, 52.0, 58.0, 59.0, 60.0, 63.0, 65.0, 66.0, 68.0, 72.0, 76.0, 76.0, 77.0, 79.0, 83.0, 91.0, 93.0]",36,23,13,0.6388888888888888,0.3611111111111111
268,2576227,"[10.0, 14.0, 26.0, 29.0, 30.0, 34.0, 34.0, 37.0, 37.0, 42.0, 47.0, 48.0, 53.0, 61.0, 66.0, 71.0, 73.0, 74.0, 76.0, 77.0, 80.0, 83.0, 88.0]",23,13,10,0.5652173913043478,0.43478260869565216
269,2576228,"[2.0, 33.0, 42.0, 45.0, 46.0, 52.0, 54.0, 56.0, 63.0, 71.0, 80.0, 80.0, 85.0, 87.0, 91.0]",15,8,7,0.5333333333333333,0.4666666666666667
270,2576229,"[1.0, 9.0, 23.0, 28.0, 29.0, 32.0, 36.0, 39.0, 40.0, 49.0, 48.0, 55.0, 56.0, 57.0, 64.0, 65.0, 68.0, 71.0, 75.0, 80.0, 82.0, 83.0, 84.0, 85.0, 88.0, 90.0, 91.0, 92.0]",28,14,14,0.5,0.5
271,2576230,"[8.0, 8.0, 15.0, 21.0, 22.0, 25.0, 29.0, 31.0, 37.0, 46.0, 50.0, 55.0, 63.0, 68.0, 85.0, 88.0, 88.0, 90.0, 92.0, 93.0, 93.0]",21,12,9,0.5714285714285714,0.42857142857142855
272,2576231,"[7.0, 11.0, 12.0, 16.0, 25.0, 33.0, 35.0, 36.0, 39.0, 49.0, 52.0, 53.0, 66.0, 70.0, 86.0, 94.0, 95.0]",17,12,5,0.7058823529411765,0.29411764705882354
273,2576232,"[3.0, 3.0, 23.0, 25.0, 25.0, 32.0, 74.0, 78.0, 79.0, 86.0, 93.0, 94.0, 94.0]",13,6,7,0.46153846153846156,0.5384615384615384
274,2576233,"[7.0, 9.0, 28.0, 39.0, 40.0, 40.0, 45.0, 46.0, 51.0, 56.0, 59.0, 60.0, 61.0, 63.0, 63.0, 66.0, 69.0, 90.0, 92.0, 94.0]",20,11,9,0.55,0.45
275,2576234,"[3.0, 14.0, 24.0, 36.0, 48.0, 51.0, 63.0, 67.0, 70.0, 73.0, 77.0, 79.0, 80.0, 93.0]",14,6,8,0.42857142857142855,0.5714285714285714
276,2576235,"[5.0, 6.0, 11.0, 19.0, 22.0, 27.0, 28.0, 34.0, 36.0, 36.0, 47.0, 52.0, 55.0, 62.0, 64.0, 69.0, 74.0, 74.0, 83.0, 84.0, 92.0, 94.0]",22,13,9,0.5909090909090909,0.4090909090909091
277,2576236,"[1.0, 6.0, 14.0, 25.0, 27.0, 33.0, 35.0, 46.0, 46.0, 46.0, 46.0, 54.0, 58.0, 68.0, 85.0, 86.0]",16,13,3,0.8125,0.1875
278,2576237,"[14.0, 18.0, 24.0, 31.0, 32.0, 34.0, 38.0, 42.0, 43.0, 46.0, 47.0, 53.0, 55.0, 59.0, 62.0, 63.0, 69.0, 73.0, 77.0, 83.0, 89.0, 92.0]",22,14,8,0.6363636363636364,0.36363636363636365
279,2576238,"[1.0, 4.0, 26.0, 31.0, 44.0, 47.0, 48.0, 56.0, 77.0, 80.0, 82.0, 86.0, 89.0]",13,8,5,0.6153846153846154,0.38461538461538464
280,2576239,"[2.0, 5.0, 7.0, 18.0, 19.0, 23.0, 31.0, 33.0, 35.0, 46.0, 48.0, 50.0, 59.0, 68.0, 70.0, 71.0, 71.0, 74.0, 76.0, 77.0, 79.0, 82.0, 87.0, 88.0]",24,13,11,0.5416666666666666,0.4583333333333333
281,2576240,"[3.0, 3.0, 9.0, 10.0, 11.0, 16.0, 23.0, 24.0, 29.0, 29.0, 40.0, 41.0, 43.0, 47.0, 47.0, 48.0, 49.0, 50.0, 59.0, 59.0, 62.0, 66.0, 72.0, 76.0, 79.0, 80.0, 83.0, 92.0]",28,20,8,0.7142857142857143,0.2857142857142857
282,2576241,"[10.0, 14.0, 17.0, 23.0, 23.0, 36.0, 40.0, 41.0, 44.0, 46.0, 51.0, 51.0, 51.0, 53.0, 69.0, 73.0, 79.0, 82.0, 86.0, 86.0, 91.0, 91.0, 92.0]",23,14,9,0.6086956521739131,0.391304347826087
283,2576242,"[9.0, 16.0, 19.0, 21.0, 32.0, 34.0, 36.0, 37.0, 41.0, 49.0, 52.0, 52.0, 57.0, 63.0, 67.0, 68.0, 68.0, 73.0, 74.0, 76.0, 81.0, 82.0, 90.0]",23,13,10,0.5652173913043478,0.43478260869565216
284,2576243,"[11.0, 15.0, 19.0, 24.0, 37.0, 40.0, 42.0, 45.0, 46.0, 49.0, 51.0, 58.0, 62.0, 67.0, 69.0, 72.0, 86.0, 87.0, 87.0, 90.0]",20,12,8,0.6,0.4
285,2576244,"[4.0, 10.0, 10.0, 13.0, 14.0, 15.0, 21.0, 26.0, 31.0, 33.0, 34.0, 36.0, 39.0, 44.0, 44.0, 51.0, 53.0, 57.0, 58.0, 63.0, 65.0, 69.0, 72.0, 73.0, 76.0, 87.0]",26,19,7,0.7307692307692307,0.2692307692307692
286,2576245,"[7.0, 12.0, 18.0, 21.0, 22.0, 26.0, 31.0, 34.0, 34.0, 36.0, 37.0, 40.0, 44.0, 44.0, 46.0, 51.0, 52.0, 54.0, 64.0, 67.0, 76.0, 81.0]",22,18,4,0.8181818181818182,0.18181818181818182
287,2576246,"[7.0, 7.0, 10.0, 11.0, 16.0, 35.0, 36.0, 41.0, 49.0, 54.0, 73.0, 81.0, 87.0, 93.0]",14,10,4,0.7142857142857143,0.2857142857142857
288,2576247,"[5.0, 11.0, 11.0, 14.0, 16.0, 20.0, 33.0, 37.0, 39.0, 46.0, 50.0, 52.0, 55.0, 56.0, 56.0, 63.0, 65.0, 66.0, 74.0, 79.0, 79.0, 79.0, 80.0, 82.0, 84.0, 89.0, 91.0, 92.0]",28,15,13,0.5357142857142857,0.4642857142857143
289,2576248,"[9.0, 18.0, 19.0, 26.0, 30.0, 35.0, 39.0, 44.0, 48.0, 50.0, 52.0, 63.0, 68.0, 70.0, 72.0, 74.0, 82.0, 83.0, 91.0, 95.0]",20,11,9,0.55,0.45
290,2576249,"[2.0, 6.0, 13.0, 17.0, 19.0, 21.0, 30.0, 32.0, 37.0, 39.0, 41.0, 50.0, 51.0, 51.0, 55.0, 58.0, 60.0, 64.0, 65.0, 67.0, 69.0, 78.0, 79.0, 83.0, 86.0, 87.0, 87.0]",27,16,11,0.5925925925925926,0.4074074074074074
291,2576250,"[2.0, 2.0, 9.0, 22.0, 37.0, 40.0, 49.0, 53.0, 55.0, 62.0, 62.0, 66.0, 70.0, 71.0, 76.0, 90.0, 90.0]",17,9,8,0.5294117647058824,0.47058823529411764
292,2576251,"[1.0, 8.0, 8.0, 11.0, 12.0, 17.0, 22.0, 26.0, 30.0, 32.0, 43.0, 45.0, 45.0, 46.0, 47.0, 48.0, 51.0, 57.0, 58.0, 62.0, 68.0, 71.0, 72.0, 75.0, 78.0, 82.0, 82.0, 83.0, 87.0, 93.0, 93.0]",31,19,12,0.6129032258064516,0.3870967741935484
293,2576252,"[6.0, 7.0, 8.0, 12.0, 13.0, 15.0, 28.0, 30.0, 33.0, 49.0, 53.0, 54.0, 55.0, 56.0, 69.0, 79.0, 87.0]",17,14,3,0.8235294117647058,0.17647058823529413
294,2576253,"[7.0, 8.0, 18.0, 22.0, 22.0, 25.0, 35.0, 39.0, 46.0, 50.0, 50.0, 51.0, 57.0, 61.0, 68.0, 76.0, 79.0, 83.0, 94.0]",19,13,6,0.6842105263157895,0.3157894736842105
295,2576254,"[4.0, 6.0, 6.0, 17.0, 18.0, 18.0, 19.0, 21.0, 25.0, 28.0, 28.0, 29.0, 41.0, 62.0, 64.0, 68.0, 76.0, 84.0, 87.0, 90.0, 93.0]",21,13,8,0.6190476190476191,0.38095238095238093
296,2576255,"[0.0, 5.0, 5.0, 6.0, 13.0, 16.0, 17.0, 20.0, 25.0, 28.0, 36.0, 61.0, 64.0, 68.0, 69.0, 72.0, 77.0, 79.0, 90.0, 93.0, 95.0]",21,11,10,0.5238095238095238,0.47619047619047616
297,2576256,"[8.0, 10.0, 15.0, 22.0, 42.0, 46.0, 50.0, 51.0, 57.0, 57.0, 60.0, 66.0, 68.0, 68.0, 75.0, 75.0, 78.0, 84.0, 87.0, 89.0]",20,10,10,0.5,0.5
298,2576257,"[7.0, 10.0, 10.0, 22.0, 24.0, 27.0, 30.0, 40.0, 44.0, 47.0, 47.0, 50.0, 52.0, 56.0, 61.0, 61.0, 63.0, 65.0, 68.0, 76.0, 76.0, 79.0, 83.0, 86.0]",24,14,10,0.5833333333333334,0.4166666666666667
299,2576258,"[2.0, 7.0, 10.0, 15.0, 20.0, 26.0, 29.0, 29.0, 34.0, 36.0, 37.0, 40.0, 40.0, 43.0, 48.0, 53.0, 54.0, 59.0, 61.0, 67.0, 69.0, 71.0, 74.0, 77.0, 77.0, 78.0, 78.0, 90.0]",28,18,10,0.6428571428571429,0.35714285714285715
300,2576259,"[1.0, 3.0, 9.0, 13.0, 17.0, 20.0, 21.0, 25.0, 38.0, 48.0, 50.0, 51.0, 54.0, 62.0, 67.0, 67.0, 76.0, 76.0, 80.0, 81.0, 85.0, 85.0]",22,13,9,0.5909090909090909,0.4090909090909091
301,2576260,"[2.0, 10.0, 14.0, 25.0, 34.0, 49.0, 51.0, 59.0, 62.0, 64.0, 65.0, 72.0, 75.0, 75.0]",14,8,6,0.5714285714285714,0.42857142857142855
302,2576261,"[2.0, 11.0, 19.0, 24.0, 32.0, 38.0, 38.0, 39.0, 49.0, 47.0, 57.0, 62.0, 67.0, 67.0, 70.0, 82.0, 82.0, 91.0, 92.0]",19,11,8,0.5789473684210527,0.42105263157894735
303,2576262,"[3.0, 15.0, 17.0, 21.0, 22.0, 29.0, 30.0, 34.0, 36.0, 38.0, 41.0, 43.0, 44.0, 47.0, 50.0, 52.0, 53.0, 54.0, 57.0, 57.0, 61.0, 69.0, 73.0, 75.0, 76.0, 78.0, 80.0, 80.0, 82.0, 83.0, 84.0, 85.0, 87.0, 88.0, 92.0, 93.0]",36,20,16,0.5555555555555556,0.4444444444444444
304,2576263,"[6.0, 9.0, 10.0, 12.0, 13.0, 14.0, 15.0, 22.0, 24.0, 26.0, 39.0, 45.0, 46.0, 48.0, 52.0, 53.0, 55.0, 67.0, 67.0, 68.0, 71.0, 73.0, 74.0, 83.0, 84.0, 96.0]",26,17,9,0.6538461538461539,0.34615384615384615
305,2576264,"[4.0, 7.0, 13.0, 17.0, 21.0, 21.0, 22.0, 28.0, 44.0, 47.0, 49.0, 51.0, 62.0, 63.0, 65.0, 73.0, 75.0, 77.0, 79.0, 79.0, 83.0, 88.0, 89.0]",23,12,11,0.5217391304347826,0.4782608695652174
306,2576265,"[4.0, 4.0, 11.0, 12.0, 13.0, 18.0, 20.0, 30.0, 31.0, 34.0, 36.0, 41.0, 49.0, 51.0, 54.0, 57.0, 59.0, 66.0, 69.0, 84.0, 86.0, 90.0]",22,17,5,0.7727272727272727,0.22727272727272727
307,2576266,"[4.0, 5.0, 7.0, 15.0, 16.0, 21.0, 21.0, 24.0, 24.0, 33.0, 41.0, 50.0, 51.0, 53.0, 53.0, 61.0, 69.0, 71.0, 72.0, 76.0, 82.0, 83.0, 93.0, 93.0]",24,15,9,0.625,0.375
308,2576267,"[2.0, 7.0, 8.0, 10.0, 12.0, 17.0, 19.0, 21.0, 24.0, 26.0, 26.0, 37.0, 48.0, 56.0, 57.0, 63.0, 65.0, 69.0, 76.0, 78.0, 88.0, 91.0, 94.0]",23,15,8,0.6521739130434783,0.34782608695652173
309,2576268,"[1.0, 1.0, 8.0, 13.0, 14.0, 16.0, 23.0, 24.0, 25.0, 32.0, 32.0, 34.0, 35.0, 42.0, 45.0, 48.0, 57.0, 60.0, 63.0, 69.0, 69.0, 73.0, 75.0, 83.0, 83.0, 85.0, 91.0, 92.0, 95.0]",29,17,12,0.5862068965517241,0.41379310344827586
310,2576269,"[15.0, 19.0, 21.0, 26.0, 39.0, 40.0, 44.0, 50.0, 51.0, 51.0, 54.0, 55.0, 61.0, 64.0, 72.0, 72.0, 76.0, 80.0, 80.0, 90.0, 91.0, 92.0, 94.0]",23,12,11,0.5217391304347826,0.4782608695652174
311,2576270,"[3.0, 7.0, 12.0, 18.0, 19.0, 22.0, 22.0, 26.0, 27.0, 29.0, 38.0, 40.0, 41.0, 44.0, 44.0, 53.0, 53.0, 60.0, 67.0, 77.0, 79.0, 81.0, 87.0, 87.0, 87.0, 87.0]",26,17,9,0.6538461538461539,0.34615384615384615
312,2576271,"[6.0, 11.0, 13.0, 15.0, 17.0, 33.0, 40.0, 42.0, 44.0, 48.0, 49.0, 52.0, 55.0, 69.0, 74.0, 81.0, 88.0, 90.0, 92.0, 94.0, 94.0]",21,13,8,0.6190476190476191,0.38095238095238093
313,2576272,"[1.0, 5.0, 14.0, 17.0, 18.0, 24.0, 27.0, 27.0, 30.0, 30.0, 40.0, 41.0, 42.0, 43.0, 51.0, 52.0, 61.0, 69.0, 70.0, 78.0, 84.0, 84.0, 86.0, 87.0, 88.0, 89.0, 92.0]",27,16,11,0.5925925925925926,0.4074074074074074
314,2576273,"[2.0, 3.0, 11.0, 14.0, 16.0, 18.0, 23.0, 26.0, 31.0, 35.0, 38.0, 39.0, 40.0, 47.0, 50.0, 52.0, 53.0, 67.0, 67.0, 81.0, 83.0, 84.0, 85.0, 91.0]",24,17,7,0.7083333333333334,0.2916666666666667
315,2576274,"[7.0, 28.0, 29.0, 37.0, 58.0, 61.0, 65.0, 74.0, 75.0, 86.0, 87.0, 90.0, 90.0, 91.0, 94.0]",15,5,10,0.3333333333333333,0.6666666666666666
316,2576275,"[3.0, 4.0, 6.0, 12.0, 12.0, 14.0, 18.0, 21.0, 25.0, 34.0, 44.0, 46.0, 46.0, 50.0, 55.0, 59.0, 65.0, 74.0, 85.0, 88.0, 91.0]",21,16,5,0.7619047619047619,0.23809523809523808
317,2576276,"[5.0, 7.0, 14.0, 23.0, 26.0, 26.0, 27.0, 37.0, 37.0, 39.0, 40.0, 41.0, 42.0, 44.0, 55.0, 66.0, 67.0, 70.0, 71.0, 77.0, 82.0, 85.0, 86.0, 90.0, 92.0]",25,15,10,0.6,0.4
318,2576277,"[1.0, 11.0, 14.0, 19.0, 21.0, 47.0, 53.0, 60.0, 62.0, 69.0, 71.0, 75.0, 80.0, 91.0, 91.0]",15,7,8,0.4666666666666667,0.5333333333333333
319,2576278,"[10.0, 15.0, 17.0, 21.0, 24.0, 36.0, 41.0, 43.0, 53.0, 59.0, 65.0, 66.0, 70.0, 81.0, 83.0, 91.0]",16,10,6,0.625,0.375
320,2576279,"[6.0, 6.0, 10.0, 18.0, 19.0, 19.0, 19.0, 20.0, 22.0, 33.0, 35.0, 36.0, 48.0, 53.0, 54.0, 67.0, 68.0, 71.0, 77.0, 79.0, 80.0]",21,15,6,0.7142857142857143,0.2857142857142857
321,2576280,"[6.0, 6.0, 11.0, 13.0, 21.0, 27.0, 30.0, 40.0, 43.0, 52.0, 53.0, 57.0, 61.0, 62.0, 64.0, 77.0, 79.0, 82.0, 85.0, 86.0, 89.0, 93.0]",22,12,10,0.5454545454545454,0.45454545454545453
322,2576281,"[8.0, 9.0, 9.0, 12.0, 14.0, 20.0, 21.0, 23.0, 33.0, 42.0, 49.0, 59.0, 65.0, 72.0, 74.0, 81.0, 82.0, 85.0, 89.0]",19,12,7,0.631578947368421,0.3684210526315789
323,2576282,"[5.0, 6.0, 20.0, 22.0, 23.0, 23.0, 26.0, 41.0, 53.0, 58.0, 65.0, 67.0, 75.0, 88.0]",14,10,4,0.7142857142857143,0.2857142857142857
324,2576283,"[6.0, 14.0, 17.0, 20.0, 22.0, 25.0, 40.0, 40.0, 45.0, 55.0, 60.0, 62.0, 62.0, 67.0, 68.0, 82.0, 84.0, 87.0, 91.0]",19,10,9,0.5263157894736842,0.47368421052631576
325,2576284,"[16.0, 26.0, 32.0, 35.0, 43.0, 44.0, 48.0, 51.0, 54.0, 59.0, 65.0, 65.0, 70.0, 72.0, 78.0, 79.0, 81.0, 82.0]",18,10,8,0.5555555555555556,0.4444444444444444
326,2576285,"[6.0, 10.0, 12.0, 12.0, 13.0, 17.0, 26.0, 32.0, 34.0, 35.0, 45.0, 45.0, 46.0, 47.0, 49.0, 49.0, 54.0, 62.0, 66.0, 68.0, 69.0, 72.0, 80.0, 85.0, 85.0, 92.0]",26,17,9,0.6538461538461539,0.34615384615384615
327,2576286,"[9.0, 9.0, 28.0, 32.0, 33.0, 38.0, 40.0, 59.0, 61.0, 62.0, 69.0, 69.0, 70.0, 80.0, 87.0, 88.0, 96.0]",17,8,9,0.47058823529411764,0.5294117647058824
328,2576287,"[2.0, 6.0, 18.0, 22.0, 23.0, 23.0, 23.0, 31.0, 36.0, 38.0, 47.0, 48.0, 48.0, 49.0, 50.0, 59.0, 78.0, 78.0, 85.0, 86.0, 91.0, 95.0]",22,16,6,0.7272727272727273,0.2727272727272727
329,2576288,"[6.0, 7.0, 9.0, 15.0, 15.0, 20.0, 21.0, 26.0, 30.0, 35.0, 39.0, 40.0, 46.0, 47.0, 48.0, 46.0, 48.0, 49.0, 53.0, 55.0, 55.0, 55.0, 58.0, 63.0, 65.0, 65.0, 70.0, 70.0, 72.0, 74.0, 80.0, 83.0, 83.0, 87.0]",34,23,11,0.6764705882352942,0.3235294117647059
330,2576289,"[11.0, 18.0, 20.0, 28.0, 33.0, 36.0, 37.0, 41.0, 42.0, 42.0, 43.0, 45.0, 48.0, 52.0, 54.0, 56.0, 60.0, 64.0, 66.0, 70.0, 70.0, 73.0, 73.0, 84.0, 88.0, 88.0]",26,16,10,0.6153846153846154,0.38461538461538464
331,2576290,"[4.0, 14.0, 20.0, 29.0, 40.0, 41.0, 44.0, 53.0, 55.0, 58.0, 59.0, 61.0, 63.0, 70.0, 72.0]",15,11,4,0.7333333333333333,0.26666666666666666
332,2576291,"[5.0, 7.0, 8.0, 16.0, 30.0, 32.0, 33.0, 34.0, 38.0, 39.0, 44.0, 59.0, 60.0, 60.0, 62.0, 64.0, 71.0, 77.0, 78.0, 80.0, 82.0, 86.0, 86.0, 87.0, 88.0, 89.0]",26,12,14,0.46153846153846156,0.5384615384615384
333,2576292,"[3.0, 36.0, 40.0, 46.0, 57.0, 58.0, 62.0, 68.0, 69.0, 70.0, 80.0, 91.0, 92.0]",13,6,7,0.46153846153846156,0.5384615384615384
334,2576293,"[1.0, 3.0, 4.0, 6.0, 17.0, 32.0, 34.0, 43.0, 44.0, 47.0, 52.0, 55.0, 56.0, 59.0, 63.0, 70.0, 72.0, 77.0, 77.0, 77.0, 84.0, 84.0, 92.0]",23,14,9,0.6086956521739131,0.391304347826087
335,2576294,"[7.0, 12.0, 12.0, 12.0, 15.0, 22.0, 38.0, 44.0, 45.0, 47.0, 50.0, 50.0, 60.0, 61.0, 64.0, 72.0, 73.0, 77.0, 82.0, 89.0, 95.0]",21,12,9,0.5714285714285714,0.42857142857142855
336,2576295,"[1.0, 13.0, 17.0, 19.0, 21.0, 23.0, 27.0, 32.0, 51.0, 54.0, 55.0, 68.0, 80.0, 83.0, 89.0]",15,11,4,0.7333333333333333,0.26666666666666666
337,2576296,"[11.0, 21.0, 22.0, 23.0, 31.0, 41.0, 44.0, 46.0, 47.0, 49.0, 51.0, 55.0, 56.0, 59.0, 61.0, 64.0, 66.0, 68.0, 69.0]",19,14,5,0.7368421052631579,0.2631578947368421
338,2576297,"[23.0, 28.0, 31.0, 35.0, 37.0, 37.0, 37.0, 42.0, 42.0, 45.0, 45.0, 47.0, 49.0, 53.0, 56.0, 62.0, 73.0, 79.0, 82.0, 84.0, 88.0]",21,15,6,0.7142857142857143,0.2857142857142857
339,2576298,"[3.0, 6.0, 11.0, 11.0, 19.0, 28.0, 31.0, 31.0, 31.0, 37.0, 37.0, 41.0, 44.0, 49.0, 51.0, 53.0, 55.0, 57.0, 59.0, 60.0, 60.0, 61.0, 62.0, 64.0, 70.0, 71.0, 73.0, 75.0, 77.0, 84.0, 89.0]",31,19,12,0.6129032258064516,0.3870967741935484
340,2576299,"[3.0, 6.0, 21.0, 21.0, 26.0, 32.0, 36.0, 49.0, 45.0, 49.0, 56.0, 63.0, 66.0, 71.0, 71.0, 76.0, 86.0, 86.0, 93.0]",19,11,8,0.5789473684210527,0.42105263157894735
341,2576300,"[5.0, 7.0, 8.0, 10.0, 20.0, 20.0, 28.0, 29.0, 40.0, 47.0, 47.0, 49.0, 50.0, 54.0, 60.0, 65.0, 66.0, 67.0, 68.0, 74.0, 82.0, 82.0, 83.0, 85.0, 86.0, 87.0, 90.0]",27,14,13,0.5185185185185185,0.48148148148148145
342,2576301,"[6.0, 7.0, 10.0, 10.0, 16.0, 22.0, 25.0, 25.0, 39.0, 45.0, 47.0, 55.0, 62.0, 63.0, 65.0, 66.0, 73.0, 79.0, 82.0, 83.0, 89.0]",21,12,9,0.5714285714285714,0.42857142857142855
343,2576302,"[13.0, 23.0, 25.0, 29.0, 42.0, 43.0, 47.0, 48.0, 49.0, 52.0, 59.0, 62.0, 73.0, 83.0, 83.0, 88.0, 93.0, 93.0, 95.0]",19,11,8,0.5789473684210527,0.42105263157894735
344,2576303,"[1.0, 6.0, 7.0, 33.0, 40.0, 44.0, 46.0, 47.0, 55.0, 55.0, 58.0, 58.0, 62.0, 67.0, 70.0, 70.0, 71.0, 73.0, 74.0, 83.0, 85.0, 88.0]",22,12,10,0.5454545454545454,0.45454545454545453
345,2576304,"[13.0, 17.0, 18.0, 20.0, 33.0, 37.0, 42.0, 45.0, 50.0, 50.0, 51.0, 55.0, 56.0, 59.0, 61.0, 62.0, 72.0, 74.0, 75.0, 77.0]",20,14,6,0.7,0.3
346,2576305,"[9.0, 12.0, 16.0, 34.0, 36.0, 37.0, 42.0, 42.0, 44.0, 44.0, 45.0, 49.0, 50.0, 51.0, 55.0, 56.0, 57.0, 58.0, 62.0, 65.0, 66.0, 69.0, 73.0, 76.0, 78.0, 80.0, 85.0, 92.0]",28,18,10,0.6428571428571429,0.35714285714285715
347,2576306,"[3.0, 10.0, 13.0, 14.0, 15.0, 19.0, 20.0, 22.0, 30.0, 35.0, 40.0, 43.0, 45.0, 54.0, 55.0, 56.0, 57.0, 62.0, 66.0, 72.0, 85.0, 88.0, 92.0]",23,17,6,0.7391304347826086,0.2608695652173913
348,2576307,"[1.0, 2.0, 7.0, 12.0, 18.0, 19.0, 28.0, 29.0, 30.0, 32.0, 33.0, 41.0, 42.0, 45.0, 50.0, 50.0, 51.0, 52.0, 64.0, 67.0, 71.0, 71.0, 75.0, 76.0, 83.0, 83.0, 89.0, 92.0]",28,18,10,0.6428571428571429,0.35714285714285715
349,2576308,"[7.0, 12.0, 19.0, 22.0, 27.0, 30.0, 39.0, 43.0, 45.0, 47.0, 50.0, 59.0, 60.0, 61.0, 62.0, 69.0, 77.0, 79.0, 83.0, 85.0, 86.0, 89.0, 93.0, 95.0]",24,12,12,0.5,0.5
350,2576309,"[2.0, 9.0, 9.0, 11.0, 17.0, 17.0, 18.0, 24.0, 25.0, 27.0, 28.0, 31.0, 40.0, 41.0, 43.0, 49.0, 50.0, 54.0, 66.0, 67.0, 69.0, 76.0, 77.0, 78.0, 82.0, 86.0, 86.0, 88.0, 90.0, 92.0]",30,18,12,0.6,0.4
351,2576310,"[7.0, 13.0, 21.0, 25.0, 25.0, 27.0, 31.0, 37.0, 42.0, 53.0, 63.0, 76.0, 91.0, 93.0]",14,10,4,0.7142857142857143,0.2857142857142857
352,2576311,"[6.0, 19.0, 21.0, 25.0, 32.0, 39.0, 46.0, 46.0, 53.0, 53.0, 59.0, 63.0, 68.0, 76.0, 77.0, 83.0, 92.0]",17,11,6,0.6470588235294118,0.35294117647058826
353,2576312,"[5.0, 9.0, 12.0, 14.0, 14.0, 14.0, 18.0, 21.0, 25.0, 46.0, 46.0, 48.0, 56.0, 57.0, 57.0, 63.0, 72.0, 82.0, 86.0, 89.0, 93.0]",21,15,6,0.7142857142857143,0.2857142857142857
354,2576313,"[8.0, 12.0, 17.0, 23.0, 32.0, 43.0, 50.0, 63.0, 65.0, 66.0, 67.0, 69.0, 70.0, 74.0, 76.0, 76.0, 76.0, 77.0, 78.0, 79.0, 80.0, 87.0, 89.0, 93.0]",24,7,17,0.2916666666666667,0.7083333333333334
355,2576314,"[2.0, 6.0, 7.0, 9.0, 9.0, 10.0, 15.0, 17.0, 20.0, 23.0, 27.0, 29.0, 32.0, 37.0, 38.0, 49.0, 53.0, 56.0, 64.0, 74.0, 84.0, 89.0, 91.0, 92.0]",24,18,6,0.75,0.25
356,2576315,"[5.0, 8.0, 11.0, 12.0, 14.0, 16.0, 17.0, 21.0, 23.0, 23.0, 24.0, 30.0, 32.0, 32.0, 33.0, 35.0, 36.0, 38.0, 41.0, 43.0, 45.0, 46.0, 52.0, 57.0, 63.0, 71.0, 71.0, 72.0, 78.0, 84.0, 87.0]",31,24,7,0.7741935483870968,0.22580645161290322
357,2576316,"[0.0, 8.0, 12.0, 14.0, 17.0, 32.0, 38.0, 45.0, 46.0, 46.0, 52.0, 56.0, 58.0, 65.0, 67.0, 79.0, 83.0, 84.0, 92.0, 92.0, 93.0]",21,13,8,0.6190476190476191,0.38095238095238093
358,2576317,"[5.0, 8.0, 25.0, 25.0, 26.0, 26.0, 28.0, 32.0, 33.0, 38.0, 40.0, 44.0, 47.0, 50.0, 63.0, 64.0, 67.0, 87.0]",18,14,4,0.7777777777777778,0.2222222222222222
359,2576318,"[14.0, 15.0, 17.0, 20.0, 24.0, 25.0, 39.0, 41.0, 54.0, 56.0, 58.0, 59.0, 62.0, 66.0, 69.0, 69.0, 70.0, 76.0, 77.0, 82.0, 93.0]",21,12,9,0.5714285714285714,0.42857142857142855
360,2576319,"[0.0, 1.0, 4.0, 8.0, 9.0, 23.0, 34.0, 35.0, 36.0, 43.0, 44.0, 48.0, 49.0, 50.0, 63.0, 65.0, 67.0, 71.0, 72.0, 72.0, 80.0, 83.0, 87.0, 89.0, 92.0]",25,14,11,0.56,0.44
361,2576320,"[1.0, 11.0, 16.0, 21.0, 24.0, 26.0, 26.0, 31.0, 32.0, 47.0, 58.0, 59.0, 61.0, 75.0, 83.0, 84.0, 88.0, 93.0]",18,12,6,0.6666666666666666,0.3333333333333333
362,2576321,"[15.0, 15.0, 21.0, 27.0, 28.0, 35.0, 43.0, 49.0, 53.0, 61.0, 65.0, 71.0, 71.0, 72.0, 73.0, 73.0, 75.0, 76.0, 77.0, 77.0, 79.0, 79.0, 82.0, 84.0, 86.0, 91.0]",26,9,17,0.34615384615384615,0.6538461538461539
363,2576322,"[7.0, 10.0, 10.0, 25.0, 25.0, 34.0, 38.0, 40.0, 41.0, 64.0, 65.0, 70.0, 76.0, 80.0]",14,9,5,0.6428571428571429,0.35714285714285715
364,2576323,"[2.0, 12.0, 26.0, 29.0, 39.0, 41.0, 41.0, 44.0, 46.0, 54.0, 57.0, 60.0, 67.0, 68.0, 69.0, 73.0, 79.0, 83.0, 85.0, 87.0, 91.0, 94.0]",22,11,11,0.5,0.5
365,2576324,"[6.0, 18.0, 19.0, 21.0, 22.0, 23.0, 25.0, 33.0, 39.0, 41.0, 41.0, 41.0, 52.0, 52.0, 52.0, 53.0, 54.0, 55.0, 55.0, 58.0, 58.0, 58.0, 60.0, 66.0, 68.0, 68.0, 74.0, 80.0, 82.0, 91.0]",30,22,8,0.7333333333333333,0.26666666666666666
366,2576325,"[4.0, 13.0, 16.0, 23.0, 24.0, 26.0, 32.0, 39.0, 42.0, 43.0, 48.0, 52.0, 61.0, 62.0, 68.0, 71.0, 72.0, 79.0, 80.0, 81.0, 83.0, 89.0, 94.0, 96.0]",24,12,12,0.5,0.5
367,2576326,"[4.0, 13.0, 20.0, 23.0, 26.0, 27.0, 31.0, 33.0, 33.0, 35.0, 36.0, 44.0, 48.0, 50.0, 51.0, 51.0, 52.0, 60.0, 62.0, 70.0, 71.0, 79.0, 81.0, 81.0, 87.0, 88.0, 95.0, 95.0]",28,17,11,0.6071428571428571,0.39285714285714285
368,2576327,"[4.0, 6.0, 17.0, 22.0, 23.0, 37.0, 40.0, 41.0, 46.0, 49.0, 50.0, 50.0, 55.0, 55.0, 56.0, 58.0, 62.0, 63.0, 66.0, 67.0, 73.0, 75.0, 77.0, 78.0, 87.0, 88.0, 91.0, 93.0]",28,16,12,0.5714285714285714,0.42857142857142855
369,2576328,"[2.0, 4.0, 4.0, 8.0, 16.0, 19.0, 19.0, 29.0, 31.0, 33.0, 34.0, 35.0, 39.0, 43.0, 48.0, 54.0, 54.0, 57.0, 61.0, 67.0, 69.0, 72.0, 83.0]",23,18,5,0.782608695652174,0.21739130434782608
370,2576329,"[14.0, 15.0, 21.0, 21.0, 24.0, 39.0, 47.0, 49.0, 54.0, 55.0, 64.0, 70.0, 78.0, 86.0, 88.0, 89.0, 95.0]",17,10,7,0.5882352941176471,0.4117647058823529
371,2576330,"[5.0, 13.0, 17.0, 24.0, 27.0, 37.0, 44.0, 45.0, 49.0, 49.0, 65.0, 66.0, 75.0, 84.0, 85.0, 89.0]",16,10,6,0.625,0.375
372,2576331,"[5.0, 10.0, 17.0, 22.0, 26.0, 26.0, 27.0, 29.0, 34.0, 36.0, 40.0, 40.0, 47.0, 47.0, 48.0, 53.0, 60.0, 61.0, 65.0, 67.0, 68.0, 76.0, 77.0, 82.0, 93.0]",25,16,9,0.64,0.36
373,2576332,"[11.0, 20.0, 22.0, 28.0, 29.0, 31.0, 32.0, 33.0, 34.0, 34.0, 39.0, 42.0, 43.0, 44.0, 46.0, 50.0, 56.0, 61.0, 63.0, 65.0, 66.0, 74.0, 74.0, 81.0, 87.0, 87.0, 89.0, 90.0, 93.0]",29,17,12,0.5862068965517241,0.41379310344827586
374,2576333,"[7.0, 7.0, 11.0, 12.0, 12.0, 20.0, 25.0, 41.0, 44.0, 46.0, 46.0, 47.0, 48.0, 49.0, 49.0, 51.0, 53.0, 57.0, 58.0, 60.0, 72.0, 73.0, 75.0, 79.0, 82.0, 89.0]",26,19,7,0.7307692307692307,0.2692307692307692
375,2576334,"[1.0, 4.0, 13.0, 15.0, 23.0, 24.0, 25.0, 26.0, 31.0, 32.0, 32.0, 32.0, 37.0, 39.0, 39.0, 43.0, 49.0, 49.0, 49.0, 57.0, 61.0, 65.0, 68.0, 70.0, 75.0, 79.0, 80.0, 82.0, 87.0, 93.0]",30,20,10,0.6666666666666666,0.3333333333333333
376,2576335,"[5.0, 5.0, 6.0, 7.0, 8.0, 9.0, 15.0, 21.0, 28.0, 29.0, 35.0, 38.0, 41.0, 44.0, 45.0, 46.0, 52.0, 52.0, 53.0, 55.0, 57.0, 63.0, 65.0, 74.0, 80.0, 80.0, 81.0, 82.0]",28,21,7,0.75,0.25
377,2576336,"[4.0, 9.0, 12.0, 12.0, 12.0, 17.0, 18.0, 22.0, 25.0, 28.0, 28.0, 33.0, 37.0, 38.0, 39.0, 42.0, 43.0, 43.0, 50.0, 56.0, 61.0, 63.0, 68.0, 73.0, 84.0, 87.0, 91.0, 93.0, 94.0]",29,20,9,0.6896551724137931,0.3103448275862069
378,2576337,"[1.0, 2.0, 18.0, 18.0, 31.0, 40.0, 41.0, 43.0, 48.0, 49.0, 51.0, 53.0, 55.0, 61.0, 61.0, 64.0, 65.0, 68.0, 69.0, 73.0, 76.0, 80.0, 86.0]",23,13,10,0.5652173913043478,0.43478260869565216
379,2576338,"[16.0, 17.0, 30.0, 44.0, 49.0, 53.0, 53.0, 56.0, 57.0, 59.0, 64.0, 66.0, 79.0, 84.0, 88.0]",15,10,5,0.6666666666666666,0.3333333333333333
